101039.jpg,0.16317991631799164,0.07531380753138076,0.13389121338912133,0.24686192468619247,39,221,32,180,182,148
101170.jpg,0.14644351464435146,0.18410041841004185,0.100418410041841,0.0794979079497908,35,195,24,220,160,196
10118.jpg,0.029288702928870293,0.12552301255230125,0.16736401673640167,0.2175732217573222,7,209,40,187,202,147
10309.jpg,0.029288702928870293,0.08786610878661087,0.008368200836820083,0.16317991631799164,7,218,2,200,211,198
10362.jpg,0.0,0.07531380753138076,0.10460251046025104,0.17573221757322174,0,221,25,197,221,172
104134.jpg,0.012552301255230125,0.06694560669456066,0.029288702928870293,0.15481171548117154,3,223,7,202,220,195
104975.jpg,0.2594142259414226,0.1297071129707113,0.4309623430962343,0.3514644351464435,62,208,103,155,146,52
10606.jpg,0.09623430962343096,0.14225941422594143,0.1589958158995816,0.20920502092050208,23,205,38,189,182,151
106114.jpg,0.0,0.06694560669456066,0.016736401673640166,0.1087866108786611,0,223,4,213,223,209
109019.jpg,0.04184100418410042,0.1297071129707113,0.08368200836820083,0.18828451882845187,10,208,20,194,198,174
110171.jpg,0.058577405857740586,0.20502092050209206,0.100418410041841,0.09623430962343096,14,190,24,216,176,192
111370.jpg,0.18410041841004185,0.15481171548117154,0.100418410041841,0.20502092050209206,44,202,24,190,158,166
111493.jpg,0.02092050209205021,0.11297071129707113,0.09623430962343096,0.4476987447698745,5,212,23,132,207,109
111571.jpg,0.0,0.08368200836820083,0.0,0.06276150627615062,0,219,0,224,219,224
111765.jpg,0.08368200836820083,0.14225941422594143,0.02510460251046025,0.13807531380753138,20,205,6,206,185,200
111813.jpg,0.04602510460251046,0.16736401673640167,0.2594142259414226,0.3598326359832636,11,199,62,153,188,91
112653.jpg,0.07112970711297072,0.1589958158995816,0.06276150627615062,0.16736401673640167,17,201,15,199,184,184
113917.jpg,0.09205020920502092,0.1297071129707113,0.2803347280334728,0.3179916317991632,22,208,67,163,186,96
115161.jpg,0.2217573221757322,0.18410041841004185,0.05439330543933055,0.25523012552301255,53,195,13,178,142,165
115815.jpg,0.1297071129707113,0.15481171548117154,0.0,0.32217573221757323,31,202,0,162,171,162
115908.jpg,0.08786610878661087,0.1589958158995816,0.0,0.28451882845188287,21,201,0,171,180,171
117097.jpg,0.0,0.07531380753138076,0.12552301255230125,0.17573221757322174,0,221,30,197,221,167
117805.jpg,0.2803347280334728,0.4393305439330544,0.301255230125523,0.41841004184100417,67,134,72,139,67,67
119122.jpg,0.1297071129707113,0.1799163179916318,0.07531380753138076,0.09205020920502092,31,196,18,217,165,199
120801.jpg,0.058577405857740586,0.12552301255230125,0.1087866108786611,0.17573221757322174,14,209,26,197,195,171
121058.jpg,0.02092050209205021,0.1506276150627615,0.02510460251046025,0.06694560669456066,5,203,6,223,198,217
121592.jpg,0.1589958158995816,0.18828451882845187,0.100418410041841,0.10460251046025104,38,194,24,214,156,190
121844.jpg,0.03765690376569038,0.12552301255230125,0.0041841004184100415,0.06694560669456066,9,209,1,223,200,222
121865.jpg,0.37656903765690375,0.17154811715481172,0.35564853556485354,0.33472803347280333,90,198,85,159,108,74
12263.jpg,0.2217573221757322,0.26778242677824265,0.4560669456066946,0.06694560669456066,53,175,109,223,122,114
122887.jpg,0.17573221757322174,0.22594142259414227,0.100418410041841,0.3891213389121339,42,185,24,146,143,122
123531.jpg,0.04602510460251046,0.5439330543933054,0.17154811715481172,0.4811715481171548,11,109,41,124,98,83
124454.jpg,0.13389121338912133,0.06694560669456066,0.15481171548117154,0.3305439330543933,32,223,37,160,191,123
125869.jpg,0.07531380753138076,0.09205020920502092,0.16317991631799164,0.1799163179916318,18,217,39,196,199,157
127999.jpg,0.1087866108786611,0.15481171548117154,0.08786610878661087,0.06694560669456066,26,202,21,223,176,202
128412.jpg,0.19246861924686193,0.07531380753138076,0.20920502092050208,0.29707112970711297,46,221,50,168,175,118
128878.jpg,0.0,0.06276150627615062,0.008368200836820083,0.12133891213389121,0,224,2,210,224,208
129792.jpg,0.38493723849372385,0.2803347280334728,0.13389121338912133,0.5313807531380753,92,172,32,112,80,80
12995.jpg,0.02092050209205021,0.12552301255230125,0.26778242677824265,0.34309623430962344,5,209,64,157,204,93
13120.jpg,0.09623430962343096,0.12133891213389121,0.012552301255230125,0.5271966527196653,23,210,3,113,187,110
131379.jpg,0.06276150627615062,0.07531380753138076,0.100418410041841,0.22594142259414227,15,221,24,185,206,161
131762.jpg,0.0,0.09205020920502092,0.11715481171548117,0.09623430962343096,0,217,28,216,217,188
132018.jpg,0.24267782426778242,0.200836820083682,0.012552301255230125,0.301255230125523,58,191,3,167,133,164
132250.jpg,0.36401673640167365,0.3305439330543933,0.28870292887029286,0.40585774058577406,87,160,69,142,73,73
132284.jpg,0.2719665271966527,0.1589958158995816,0.3054393305439331,0.20920502092050208,65,201,73,189,136,116
132742.jpg,0.10460251046025104,0.45188284518828453,0.2803347280334728,0.20502092050209206,25,131,67,190,106,123
132760.jpg,0.16317991631799164,0.11715481171548117,0.12552301255230125,0.09623430962343096,39,211,30,216,172,186
133213.jpg,0.0041841004184100415,0.06694560669456066,0.13389121338912133,0.20502092050209206,1,223,32,190,222,158
134599.jpg,0.058577405857740586,0.07112970711297072,0.25523012552301255,0.26778242677824265,14,222,61,175,208,114
135002.jpg,0.008368200836820083,0.06694560669456066,0.008368200836820083,0.06694560669456066,2,223,2,223,221,221
135037.jpg,0.11297071129707113,0.15481171548117154,0.5062761506276151,0.06694560669456066,27,202,121,223,175,102
135256.jpg,0.22594142259414227,0.2301255230125523,0.4895397489539749,-0.03347280334728033,54,184,117,247,130,130
136229.jpg,0.09623430962343096,0.1799163179916318,0.1799163179916318,0.2594142259414226,23,196,43,177,173,134
136381.jpg,0.06694560669456066,0.1087866108786611,0.13389121338912133,0.2719665271966527,16,213,32,174,197,142
140601.jpg,0.18410041841004185,0.14225941422594143,0.02510460251046025,0.100418410041841,44,205,6,215,161,209
141486.jpg,0.15481171548117154,0.26359832635983266,0.28870292887029286,0.301255230125523,37,176,69,167,139,98
141685.jpg,0.04184100418410042,0.12133891213389121,0.10460251046025104,0.15481171548117154,10,210,25,202,200,177
143446.jpg,0.4476987447698745,0.08368200836820083,0.2384937238493724,0.2510460251046025,107,219,57,179,112,122
144140.jpg,0.06694560669456066,0.06694560669456066,0.06694560669456066,0.15481171548117154,16,223,16,202,207,186
144476.jpg,0.0,0.08786610878661087,0.14225941422594143,0.13389121338912133,0,218,34,207,218,173
144516.jpg,0.02092050209205021,0.12552301255230125,0.0041841004184100415,0.30962343096234307,5,209,1,165,204,164
144800.jpg,0.06694560669456066,0.19246861924686193,0.0,0.13389121338912133,16,193,0,207,177,207
145593.jpg,0.03765690376569038,0.16736401673640167,0.11715481171548117,0.08786610878661087,9,199,28,218,190,190
145749.jpg,0.15481171548117154,0.14225941422594143,0.14644351464435146,0.09623430962343096,37,205,35,216,168,181
145836.jpg,0.0502092050209205,0.10460251046025104,0.09623430962343096,0.2928870292887029,12,214,23,169,202,146
145879.jpg,0.11715481171548117,0.14644351464435146,0.1589958158995816,0.16736401673640167,28,204,38,199,176,161
145976.jpg,0.100418410041841,0.18828451882845187,0.12133891213389121,0.23430962343096234,24,194,29,183,170,154
146196.jpg,0.19246861924686193,0.100418410041841,0.1506276150627615,0.13807531380753138,46,215,36,206,169,170
146289.jpg,0.05439330543933055,0.16317991631799164,0.0,0.100418410041841,13,200,0,215,187,215
146349.jpg,0.05439330543933055,0.13389121338912133,0.05439330543933055,0.06694560669456066,13,207,13,223,194,210
146357.jpg,0.08786610878661087,0.06694560669456066,0.14225941422594143,0.1506276150627615,21,223,34,203,202,169
146495.jpg,0.06694560669456066,0.06694560669456066,0.3138075313807531,0.15481171548117154,16,223,75,202,207,127
146757.jpg,0.0794979079497908,0.100418410041841,0.06694560669456066,0.16317991631799164,19,215,16,200,196,184
1468.jpg,0.0,0.09623430962343096,0.1589958158995816,0.2301255230125523,0,216,38,184,216,146
14750.jpg,0.0502092050209205,0.06694560669456066,0.20502092050209206,0.27615062761506276,12,223,49,173,211,124
148249.jpg,0.17573221757322174,0.1506276150627615,0.24686192468619247,0.06694560669456066,42,203,59,223,161,164
148916.jpg,0.08368200836820083,0.10460251046025104,0.016736401673640166,0.2301255230125523,20,214,4,184,194,180
150125.jpg,0.07531380753138076,0.08786610878661087,0.13389121338912133,0.2175732217573222,18,218,32,187,200,155
150294.jpg,0.02510460251046025,0.14644351464435146,0.0,0.3472803347280335,6,204,0,156,198,156
151463.jpg,0.27615062761506276,0.22594142259414227,0.2217573221757322,0.2803347280334728,66,185,53,172,119,119
151862.jpg,0.03347280334728033,0.10460251046025104,0.11715481171548117,0.17154811715481172,8,214,28,198,206,170
15824.jpg,0.02510460251046025,0.08786610878661087,0.1799163179916318,0.26359832635983266,6,218,43,176,212,133
158499.jpg,0.09205020920502092,0.5062761506276151,0.04184100418410042,0.4769874476987448,22,118,10,125,96,115
158540.jpg,0.1506276150627615,0.1589958158995816,0.04184100418410042,0.12133891213389121,36,201,10,210,165,200
158973.jpg,0.27615062761506276,0.20502092050209206,0.6903765690376569,0.1506276150627615,66,190,165,203,124,38
161282.jpg,0.20502092050209206,0.14644351464435146,0.0041841004184100415,0.5271966527196653,49,204,1,113,155,112
162094.jpg,0.497907949790795,0.2594142259414226,0.6401673640167364,0.1506276150627615,119,177,153,203,58,50
165601.jpg,0.012552301255230125,0.06694560669456066,0.18828451882845187,0.19665271966527198,3,223,45,192,220,147
166742.jpg,0.07531380753138076,0.21338912133891214,0.0,0.06276150627615062,18,188,0,224,170,224
166800.jpg,0.16317991631799164,0.17573221757322174,0.09623430962343096,0.16736401673640167,39,197,23,199,158,176
167074.jpg,0.22594142259414227,0.21338912133891214,0.15481171548117154,0.4476987447698745,54,188,37,132,134,95
167143.jpg,0.06276150627615062,0.18410041841004185,0.016736401673640166,0.12552301255230125,15,195,4,209,180,205
167544.jpg,0.2175732217573222,0.20502092050209206,0.4895397489539749,0.28451882845188287,52,190,117,171,138,54
167556.jpg,0.0,0.06276150627615062,0.03765690376569038,0.13389121338912133,0,224,9,207,224,198
167562.jpg,0.14644351464435146,0.19246861924686193,0.3514644351464435,0.06694560669456066,35,193,84,223,158,139
167593.jpg,0.25523012552301255,0.16317991631799164,0.3807531380753138,0.18410041841004185,61,200,91,195,139,104
167746.jpg,0.05439330543933055,0.11715481171548117,0.15481171548117154,0.19246861924686193,13,211,37,193,198,156
167919.jpg,0.13807531380753138,0.09205020920502092,0.14644351464435146,0.3389121338912134,33,217,35,158,184,123
168280.jpg,0.16736401673640167,0.11715481171548117,0.0,0.3472803347280335,40,211,0,156,171,156
168294.jpg,0.0502092050209205,0.07112970711297072,0.3305439330543933,0.2719665271966527,12,222,79,174,210,95
169557.jpg,0.5857740585774058,0.06694560669456066,0.4686192468619247,0.23430962343096234,140,223,112,183,83,71
171447.jpg,0.10460251046025104,0.200836820083682,0.008368200836820083,0.5355648535564853,25,191,2,111,166,109
171486.jpg,0.0,0.06694560669456066,0.06276150627615062,0.1799163179916318,0,223,15,196,223,181
172434.jpg,0.04184100418410042,0.12133891213389121,0.0,0.06276150627615062,10,210,0,224,200,224
172608.jpg,0.07112970711297072,0.06694560669456066,0.0502092050209205,0.06694560669456066,17,223,12,223,206,211
172752.jpg,0.03347280334728033,0.06694560669456066,0.14644351464435146,0.11297071129707113,8,223,35,212,215,177
173058.jpg,0.0794979079497908,0.200836820083682,0.016736401673640166,0.08368200836820083,19,191,4,219,172,215
174323.jpg,0.3263598326359833,0.24267782426778242,0.3807531380753138,0.22594142259414227,78,181,91,185,103,94
17549.jpg,0.0,0.0794979079497908,0.029288702928870293,0.2384937238493724,0,220,7,182,220,175
175525.jpg,0.200836820083682,0.06694560669456066,0.4309623430962343,0.26778242677824265,48,223,103,175,175,72
178054.jpg,0.14225941422594143,0.2217573221757322,0.09623430962343096,0.100418410041841,34,186,23,215,152,192
180931.jpg,0.301255230125523,0.39330543933054396,0.012552301255230125,0.6401673640167364,72,145,3,86,73,83
182744.jpg,0.0041841004184100415,0.10460251046025104,0.1589958158995816,0.2217573221757322,1,214,38,186,213,148
182776.jpg,0.200836820083682,0.17573221757322174,0.24267782426778242,0.100418410041841,48,197,58,215,149,157
184200.jpg,0.012552301255230125,0.07112970711297072,0.11715481171548117,0.17573221757322174,3,222,28,197,219,169
188101.jpg,0.02510460251046025,0.20502092050209206,0.28870292887029286,0.3179916317991632,6,190,69,163,184,94
190623.jpg,0.2217573221757322,0.1589958158995816,0.14644351464435146,0.200836820083682,53,201,35,191,148,156
205016.jpg,0.19246861924686193,0.2803347280334728,0.47280334728033474,0.0,46,172,113,239,126,126
210663.jpg,0.26778242677824265,0.14644351464435146,0.16736401673640167,0.5941422594142259,64,204,40,97,140,57
210783.jpg,0.46443514644351463,0.32217573221757323,0.5313807531380753,0.30962343096234307,111,162,127,165,51,38
215091.jpg,0.14225941422594143,0.3682008368200837,0.28451882845188287,0.34309623430962344,34,151,68,157,117,89
215452.jpg,0.05439330543933055,0.10460251046025104,0.07112970711297072,0.20920502092050208,13,214,17,189,201,172
215961.jpg,0.19246861924686193,0.06694560669456066,0.34309623430962344,0.2217573221757322,46,223,82,186,177,104
216705.jpg,0.012552301255230125,0.08786610878661087,0.2217573221757322,0.1506276150627615,3,218,53,203,215,150
217023.jpg,0.17573221757322174,0.06694560669456066,0.11715481171548117,0.1297071129707113,42,223,28,208,181,180
217368.jpg,0.029288702928870293,0.0794979079497908,0.15481171548117154,0.1589958158995816,7,220,37,201,213,164
217921.jpg,0.13807531380753138,0.06694560669456066,0.3682008368200837,0.2217573221757322,33,223,88,186,190,98
217967.jpg,0.3138075313807531,0.2803347280334728,0.5857740585774058,0.1799163179916318,75,172,140,196,97,56
218839.jpg,0.0502092050209205,0.11715481171548117,0.12552301255230125,0.20502092050209206,12,211,30,190,199,160
219020.jpg,0.12552301255230125,0.12552301255230125,0.0041841004184100415,0.29707112970711297,30,209,1,168,179,167
221015.jpg,0.07112970711297072,0.16317991631799164,0.19246861924686193,0.26359832635983266,17,200,46,176,183,130
22284.jpg,0.0,0.0794979079497908,0.008368200836820083,0.15481171548117154,0,220,2,202,220,200
223249.jpg,0.12133891213389121,0.18410041841004185,0.28451882845188287,0.06694560669456066,29,195,68,223,166,155
225021.jpg,0.02092050209205021,0.07112970711297072,0.11297071129707113,0.1799163179916318,5,222,27,196,217,169
226778.jpg,0.03765690376569038,0.06694560669456066,0.10460251046025104,0.3807531380753138,9,223,25,148,214,123
22685.jpg,0.0,0.08786610878661087,0.13807531380753138,0.19246861924686193,0,218,33,193,218,160
226946.jpg,0.100418410041841,0.18410041841004185,0.0,0.200836820083682,24,195,0,191,171,191
228125.jpg,0.14644351464435146,0.19246861924686193,0.3807531380753138,0.06694560669456066,35,193,91,223,158,132
228206.jpg,0.17154811715481172,0.07531380753138076,0.16317991631799164,0.19246861924686193,41,221,39,193,180,154
228258.jpg,0.1087866108786611,0.06694560669456066,0.19246861924686193,0.2510460251046025,26,223,46,179,197,133
228261.jpg,0.2594142259414226,0.08786610878661087,0.14225941422594143,0.2719665271966527,62,218,34,174,156,140
228810.jpg,0.0,0.06276150627615062,0.0,0.1589958158995816,0,224,0,201,224,201
228952.jpg,0.0,0.06694560669456066,0.200836820083682,0.16317991631799164,0,223,48,200,223,152
229087.jpg,0.012552301255230125,0.06694560669456066,0.03347280334728033,0.12552301255230125,3,223,8,209,220,201
229428.jpg,0.16736401673640167,0.12552301255230125,0.3179916317991632,0.08786610878661087,40,209,76,218,169,142
229602.jpg,0.09623430962343096,0.07112970711297072,0.13807531380753138,0.14225941422594143,23,222,33,205,199,172
229608.jpg,0.08786610878661087,0.12552301255230125,0.07531380753138076,0.10460251046025104,21,209,18,214,188,196
229629.jpg,0.03765690376569038,0.08368200836820083,0.13389121338912133,0.18410041841004185,9,219,32,195,210,163
229725.jpg,0.17573221757322174,0.1506276150627615,0.24686192468619247,0.19665271966527198,42,203,59,192,161,133
229749.jpg,0.03765690376569038,0.06694560669456066,0.029288702928870293,0.08786610878661087,9,223,7,218,214,211
229751.jpg,0.0,0.06276150627615062,0.05439330543933055,0.12133891213389121,0,224,13,210,224,197
229867.jpg,0.02092050209205021,0.06694560669456066,0.34309623430962344,0.2510460251046025,5,223,82,179,218,97
229902.jpg,0.03347280334728033,0.07112970711297072,0.1506276150627615,0.21338912133891214,8,222,36,188,214,152
230100.jpg,0.03765690376569038,0.1087866108786611,0.06694560669456066,0.21338912133891214,9,213,16,188,204,172
230115.jpg,0.1297071129707113,0.19665271966527198,0.058577405857740586,0.1297071129707113,31,192,14,208,161,194
230130.jpg,0.08368200836820083,0.06694560669456066,0.100418410041841,0.1799163179916318,20,223,24,196,203,172
230341.jpg,0.14644351464435146,0.06694560669456066,0.07112970711297072,0.200836820083682,35,223,17,191,188,174
230355.jpg,0.10460251046025104,0.18410041841004185,0.1297071129707113,0.08368200836820083,25,195,31,219,170,188
230369.jpg,0.1506276150627615,0.1799163179916318,0.05439330543933055,0.06694560669456066,36,196,13,223,160,210
231096.jpg,0.06694560669456066,0.13807531380753138,0.0,0.09623430962343096,16,206,0,216,190,216
232413.jpg,0.0,0.06694560669456066,0.13807531380753138,0.1799163179916318,0,223,33,196,223,163
232536.jpg,0.02092050209205021,0.11715481171548117,0.0,0.07112970711297072,5,211,0,222,206,222
232749.jpg,0.06694560669456066,0.2384937238493724,0.4769874476987448,0.29707112970711297,16,182,114,168,166,54
234268.jpg,0.16736401673640167,0.19665271966527198,0.0,0.08368200836820083,40,192,0,219,152,219
235358.jpg,0.24267782426778242,0.11297071129707113,0.2594142259414226,0.37656903765690375,58,212,62,149,154,87
236134.jpg,0.20502092050209206,0.12133891213389121,0.0,0.2510460251046025,49,210,0,179,161,179
237126.jpg,0.058577405857740586,0.06694560669456066,0.21338912133891214,0.29707112970711297,14,223,51,168,209,117
238736.jpg,0.13807531380753138,0.11715481171548117,0.3472803347280335,0.26778242677824265,33,211,83,175,178,92
240604.jpg,0.15481171548117154,0.18828451882845187,0.3138075313807531,0.0794979079497908,37,194,75,220,157,145
240898.jpg,0.0,0.07112970711297072,0.0502092050209205,0.20920502092050208,0,222,12,189,222,177
241881.jpg,0.13389121338912133,0.06694560669456066,0.3514644351464435,0.2384937238493724,32,223,84,182,191,98
242834.jpg,0.09623430962343096,0.07112970711297072,0.016736401673640166,0.10460251046025104,23,222,4,214,199,210
244560.jpg,0.03765690376569038,0.1589958158995816,0.19665271966527198,0.2301255230125523,9,201,47,184,192,137
244767.jpg,0.08368200836820083,0.0794979079497908,0.12552301255230125,0.3263598326359833,20,220,30,161,200,131
24568.jpg,0.08786610878661087,0.17573221757322174,0.012552301255230125,0.3723849372384937,21,197,3,150,176,147
245954.jpg,0.08368200836820083,0.1297071129707113,0.2594142259414226,0.30962343096234307,20,208,62,165,188,103
24606.jpg,0.301255230125523,0.37656903765690375,0.6569037656903766,0.20920502092050208,72,149,157,189,77,32
246418.jpg,0.08368200836820083,0.07531380753138076,0.25523012552301255,0.16736401673640167,20,221,61,199,201,138
24644.jpg,0.200836820083682,0.08368200836820083,0.04184100418410042,0.24267782426778242,48,219,10,181,171,171
24676.jpg,0.3598326359832636,0.18410041841004185,0.4476987447698745,0.3263598326359833,86,195,107,161,109,54
24686.jpg,0.17154811715481172,0.08786610878661087,0.17154811715481172,0.1799163179916318,41,218,41,196,177,155
247189.jpg,0.0,0.06276150627615062,0.04184100418410042,0.4602510460251046,0,224,10,129,224,119
247313.jpg,0.03765690376569038,0.2175732217573222,0.20502092050209206,0.06694560669456066,9,187,49,223,178,174
247482.jpg,0.02510460251046025,0.06694560669456066,0.08368200836820083,0.16317991631799164,6,223,20,200,217,180
247976.jpg,0.14225941422594143,0.18828451882845187,0.2719665271966527,0.08786610878661087,34,194,65,218,160,153
247981.jpg,0.1087866108786611,0.14644351464435146,0.06276150627615062,0.1589958158995816,26,204,15,201,178,186
24818.jpg,0.03347280334728033,0.100418410041841,0.08786610878661087,0.3723849372384937,8,215,21,150,207,129
24831.jpg,0.058577405857740586,0.1087866108786611,0.1087866108786611,0.14225941422594143,14,213,26,205,199,179
24882.jpg,0.1589958158995816,0.09623430962343096,0.27615062761506276,0.28451882845188287,38,216,66,171,178,105
24883.jpg,0.20920502092050208,0.17154811715481172,0.3598326359832636,0.07112970711297072,50,198,86,222,148,136
248860.jpg,0.25523012552301255,0.1297071129707113,0.100418410041841,0.18828451882845187,61,208,24,194,147,170
249250.jpg,0.35564853556485354,-0.0041841004184100415,0.11715481171548117,0.23430962343096234,85,240,28,183,155,155
24978.jpg,0.06276150627615062,0.13389121338912133,0.19246861924686193,0.06694560669456066,15,207,46,223,192,177
25104.jpg,0.06276150627615062,0.08786610878661087,0.058577405857740586,0.25523012552301255,15,218,14,178,203,164
25108.jpg,0.0,0.07531380753138076,0.13807531380753138,0.19665271966527198,0,221,33,192,221,159
25110.jpg,0.016736401673640166,0.06694560669456066,0.19246861924686193,0.20920502092050208,4,223,46,189,219,143
251403.jpg,0.03347280334728033,0.13389121338912133,0.06694560669456066,0.19246861924686193,8,207,16,193,199,177
25188.jpg,0.012552301255230125,0.06694560669456066,0.16736401673640167,0.2301255230125523,3,223,40,184,220,144
25224.jpg,0.08786610878661087,0.13389121338912133,0.24267782426778242,0.16317991631799164,21,207,58,200,186,142
252292.jpg,0.0,0.08786610878661087,0.15481171548117154,0.20920502092050208,0,218,37,189,218,152
2524.jpg,0.0502092050209205,0.20502092050209206,0.2384937238493724,0.18410041841004185,12,190,57,195,178,138
25274.jpg,0.11297071129707113,0.2301255230125523,0.0,0.06276150627615062,27,184,0,224,157,224
25280.jpg,0.058577405857740586,0.1799163179916318,0.008368200836820083,0.100418410041841,14,196,2,215,182,213
25290.jpg,0.20502092050209206,0.17573221757322174,0.016736401673640166,0.39330543933054396,49,197,4,145,148,141
257653.jpg,0.012552301255230125,0.06694560669456066,0.1589958158995816,0.1589958158995816,3,223,38,201,220,163
258092.jpg,0.0,0.06694560669456066,0.14225941422594143,0.19665271966527198,0,223,34,192,223,158
258231.jpg,0.301255230125523,0.32217573221757323,0.2719665271966527,0.3682008368200837,72,162,65,151,90,86
258502.jpg,0.14644351464435146,0.07531380753138076,0.17573221757322174,0.18828451882845187,35,221,42,194,186,152
259851.jpg,0.016736401673640166,0.36401673640167365,0.2175732217573222,0.16317991631799164,4,152,52,200,148,148
261556.jpg,0.0041841004184100415,0.14644351464435146,0.0502092050209205,0.06694560669456066,1,204,12,223,203,211
261967.jpg,0.11715481171548117,0.17154811715481172,0.1799163179916318,0.07531380753138076,28,198,43,221,170,178
262837.jpg,0.10460251046025104,0.16736401673640167,0.22594142259414227,0.06694560669456066,25,199,54,223,174,169
263056.jpg,0.32217573221757323,0.1506276150627615,0.08786610878661087,0.13389121338912133,77,203,21,207,126,186
263626.jpg,0.029288702928870293,0.07112970711297072,0.19246861924686193,0.16317991631799164,7,222,46,200,215,154
263885.jpg,0.0041841004184100415,0.06694560669456066,0.16736401673640167,0.22594142259414227,1,223,40,185,222,145
264054.jpg,0.0,0.09205020920502092,0.008368200836820083,0.06694560669456066,0,217,2,223,217,221
265541.jpg,0.13389121338912133,0.17573221757322174,0.029288702928870293,0.3263598326359833,32,197,7,161,165,154
265874.jpg,0.2175732217573222,0.2510460251046025,0.39748953974895396,0.3598326359832636,52,179,95,153,127,58
267904.jpg,0.3305439330543933,0.37656903765690375,0.3389121338912134,0.3682008368200837,79,149,81,151,70,70
268051.jpg,0.08786610878661087,0.1087866108786611,0.2217573221757322,0.3138075313807531,21,213,53,164,192,111
268294.jpg,0.0,0.07112970711297072,0.11297071129707113,0.17154811715481172,0,222,27,198,222,171
268582.jpg,0.02092050209205021,0.24686192468619247,0.18828451882845187,0.2301255230125523,5,180,45,184,175,139
268905.jpg,0.029288702928870293,0.1087866108786611,0.13389121338912133,0.19246861924686193,7,213,32,193,206,161
269387.jpg,0.11715481171548117,0.2301255230125523,0.2719665271966527,0.0794979079497908,28,184,65,220,156,155
271193.jpg,0.08786610878661087,0.13389121338912133,0.0,0.08786610878661087,21,207,0,218,186,218
273242.jpg,0.0502092050209205,0.06694560669456066,0.1506276150627615,0.16317991631799164,12,223,36,200,211,164
273722.jpg,0.09205020920502092,0.13389121338912133,0.13389121338912133,0.16736401673640167,22,207,32,199,185,167
274614.jpg,0.19665271966527198,0.14644351464435146,0.2928870292887029,0.06694560669456066,47,204,70,223,157,153
274796.jpg,0.0,0.09205020920502092,0.08368200836820083,0.14644351464435146,0,217,20,204,217,184
275478.jpg,0.12133891213389121,0.17573221757322174,0.09623430962343096,0.09623430962343096,29,197,23,216,168,193
276003.jpg,0.16317991631799164,0.16317991631799164,0.12552301255230125,0.06694560669456066,39,200,30,223,161,193
277184.jpg,0.12552301255230125,0.20920502092050208,0.19246861924686193,0.06694560669456066,30,189,46,223,159,177
277998.jpg,0.08786610878661087,0.1506276150627615,0.12552301255230125,0.2175732217573222,21,203,30,187,182,157
279270.jpg,0.04184100418410042,0.06694560669456066,0.17573221757322174,0.29707112970711297,10,223,42,168,213,126
280138.jpg,0.06276150627615062,0.0794979079497908,0.21338912133891214,0.29707112970711297,15,220,51,168,205,117
280233.jpg,0.3263598326359833,0.3305439330543933,0.13389121338912133,0.5230125523012552,78,160,32,114,82,82
280291.jpg,0.2719665271966527,0.1506276150627615,0.05439330543933055,0.24267782426778242,65,203,13,181,138,168
280493.jpg,0.0041841004184100415,0.11297071129707113,0.20920502092050208,0.2803347280334728,1,212,50,172,211,122
280797.jpg,0.12133891213389121,0.19665271966527198,0.012552301255230125,0.17573221757322174,29,192,3,197,163,194
280963.jpg,0.1589958158995816,0.17573221757322174,0.03765690376569038,0.36401673640167365,38,197,9,152,159,143
281015.jpg,0.41841004184100417,0.08786610878661087,0.3723849372384937,0.2928870292887029,100,218,89,169,118,80
281057.jpg,0.06276150627615062,0.100418410041841,0.1799163179916318,0.08368200836820083,15,215,43,219,200,176
281438.jpg,0.06276150627615062,0.06694560669456066,0.06276150627615062,0.1297071129707113,15,223,15,208,208,193
281544.jpg,0.15481171548117154,0.22594142259414227,0.03347280334728033,0.1799163179916318,37,185,8,196,148,188
281739.jpg,0.18410041841004185,0.06694560669456066,0.1589958158995816,0.20920502092050208,44,223,38,189,179,151
281742.jpg,0.06276150627615062,0.06694560669456066,0.1297071129707113,0.23430962343096234,15,223,31,183,208,152
282003.jpg,0.19665271966527198,0.18828451882845187,0.1589958158995816,0.14644351464435146,47,194,38,204,147,166
283468.jpg,0.0,0.06276150627615062,0.10460251046025104,0.14644351464435146,0,224,25,204,224,179
284156.jpg,0.3305439330543933,0.09623430962343096,0.09205020920502092,0.28451882845188287,79,216,22,171,137,149
284661.jpg,0.0,0.06276150627615062,0.012552301255230125,0.06694560669456066,0,224,3,223,224,220
285562.jpg,0.0,0.09205020920502092,0.1087866108786611,0.12552301255230125,0,217,26,209,217,183
286042.jpg,0.02092050209205021,0.06694560669456066,0.1799163179916318,0.19665271966527198,5,223,43,192,218,149
286851.jpg,0.06276150627615062,0.06694560669456066,0.08786610878661087,0.19246861924686193,15,223,21,193,208,172
286986.jpg,0.2510460251046025,0.22594142259414227,0.46443514644351463,0.09623430962343096,60,185,111,216,125,105
286995.jpg,0.20502092050209206,0.2301255230125523,0.4225941422594142,0.07112970711297072,49,184,101,222,135,121
287001.jpg,0.029288702928870293,0.11715481171548117,0.08786610878661087,0.19246861924686193,7,211,21,193,204,172
287089.jpg,0.012552301255230125,0.06694560669456066,0.03765690376569038,0.10460251046025104,3,223,9,214,220,205
287924.jpg,0.04602510460251046,0.06694560669456066,0.3807531380753138,0.06694560669456066,11,223,91,223,212,132
288231.jpg,0.09623430962343096,0.13807531380753138,0.029288702928870293,0.06694560669456066,23,206,7,223,183,216
290277.jpg,0.4100418410041841,0.24267782426778242,0.21338912133891214,0.6778242677824268,98,181,51,77,83,26
292544.jpg,0.11715481171548117,0.2594142259414226,0.07112970711297072,0.08368200836820083,28,177,17,219,149,202
294047.jpg,0.16317991631799164,0.18410041841004185,0.4100418410041841,0.13389121338912133,39,195,98,207,156,109
294172.jpg,0.0,0.1297071129707113,0.18410041841004185,0.1589958158995816,0,208,44,201,208,157
294398.jpg,0.09623430962343096,0.3389121338912134,0.04184100418410042,0.12133891213389121,23,158,10,210,135,200
294483.jpg,0.27615062761506276,0.18410041841004185,0.5941422594142259,0.200836820083682,66,195,142,191,129,49
294505.jpg,0.03765690376569038,0.06694560669456066,0.11297071129707113,0.1799163179916318,9,223,27,196,214,169
295032.jpg,0.15481171548117154,0.09205020920502092,0.16736401673640167,0.2594142259414226,37,217,40,177,180,137
295628.jpg,0.0,0.12133891213389121,0.2175732217573222,0.13807531380753138,0,210,52,206,210,154
295750.jpg,0.18828451882845187,0.100418410041841,0.3054393305439331,0.20502092050209206,45,215,73,190,170,117
295757.jpg,0.19246861924686193,0.13389121338912133,0.2510460251046025,0.07112970711297072,46,207,60,222,161,162
295772.jpg,0.5062761506276151,0.14644351464435146,0.4351464435146444,0.06694560669456066,121,204,104,223,83,119
295872.jpg,0.07531380753138076,0.14225941422594143,0.03347280334728033,0.07112970711297072,18,205,8,222,187,214
29617.jpg,0.26778242677824265,0.21338912133891214,0.34309623430962344,0.26778242677824265,64,188,82,175,124,93
296650.jpg,0.008368200836820083,0.06694560669456066,0.200836820083682,0.26359832635983266,2,223,48,176,221,128
297079.jpg,0.016736401673640166,0.15481171548117154,0.06276150627615062,0.1506276150627615,4,202,15,203,198,188
297364.jpg,0.0,0.100418410041841,0.05439330543933055,0.11715481171548117,0,215,13,211,215,198
297670.jpg,0.1799163179916318,0.06694560669456066,0.15481171548117154,0.200836820083682,43,223,37,191,180,154
297790.jpg,0.18410041841004185,0.2594142259414226,0.0,0.2384937238493724,44,177,0,182,133,182
297803.jpg,0.02510460251046025,0.09205020920502092,0.11715481171548117,0.1799163179916318,6,217,28,196,211,168
297813.jpg,0.008368200836820083,0.100418410041841,0.100418410041841,0.18410041841004185,2,215,24,195,213,171
297869.jpg,0.0041841004184100415,0.07531380753138076,0.27615062761506276,0.2928870292887029,1,221,66,169,220,103
298095.jpg,0.06276150627615062,0.09623430962343096,0.35564853556485354,0.3263598326359833,15,216,85,161,201,76
298502.jpg,0.0502092050209205,0.06694560669456066,0.24267782426778242,0.3179916317991632,12,223,58,163,211,105
298516.jpg,0.22594142259414227,0.25523012552301255,0.3807531380753138,0.45188284518828453,54,178,91,131,124,40
298535.jpg,0.02510460251046025,0.08368200836820083,0.19665271966527198,0.2384937238493724,6,219,47,182,213,135
298715.jpg,0.04184100418410042,0.08786610878661087,0.2301255230125523,0.3054393305439331,10,218,55,166,208,111
29893.jpg,0.2594142259414226,0.10460251046025104,0.25523012552301255,0.32217573221757323,62,214,61,162,152,101
300575.jpg,0.17154811715481172,0.19665271966527198,0.1297071129707113,0.2217573221757322,41,192,31,186,151,155
301339.jpg,0.1297071129707113,0.20502092050209206,0.11715481171548117,0.5857740585774058,31,190,28,99,159,71
301871.jpg,0.09205020920502092,0.0794979079497908,0.06694560669456066,0.16317991631799164,22,220,16,200,198,184
302418.jpg,0.0,0.06276150627615062,0.0,0.06276150627615062,0,224,0,224,224,224
302611.jpg,0.0,0.07112970711297072,0.0,0.17154811715481172,0,222,0,198,222,198
30268.jpg,0.02510460251046025,0.09623430962343096,0.29707112970711297,0.32217573221757323,6,216,71,162,210,91
302766.jpg,0.0,0.06694560669456066,0.04602510460251046,0.06694560669456066,0,223,11,223,223,212
302946.jpg,0.058577405857740586,0.06694560669456066,0.401673640167364,0.06694560669456066,14,223,96,223,209,127
303215.jpg,0.08368200836820083,0.1799163179916318,0.12552301255230125,0.1506276150627615,20,196,30,203,176,173
303288.jpg,0.13389121338912133,0.19665271966527198,0.016736401673640166,0.25523012552301255,32,192,4,178,160,174
305037.jpg,0.03347280334728033,0.12133891213389121,0.1799163179916318,0.40585774058577406,8,210,43,142,202,99
305422.jpg,0.14644351464435146,0.23430962343096234,0.016736401673640166,0.4476987447698745,35,183,4,132,148,128
30557.jpg,0.02510460251046025,0.10460251046025104,0.12133891213389121,0.09623430962343096,6,214,29,216,208,187
305684.jpg,0.16736401673640167,0.19665271966527198,0.100418410041841,0.06694560669456066,40,192,24,223,152,199
308338.jpg,0.07112970711297072,0.13389121338912133,0.13807531380753138,0.15481171548117154,17,207,33,202,190,169
309366.jpg,0.26778242677824265,0.1297071129707113,0.1297071129707113,0.3807531380753138,64,208,31,148,144,117
310349.jpg,0.0,0.12133891213389121,0.03765690376569038,0.09205020920502092,0,210,9,217,210,208
310584.jpg,0.0,0.100418410041841,0.04184100418410042,0.17573221757322174,0,215,10,197,215,187
311031.jpg,0.23430962343096234,0.100418410041841,0.0794979079497908,0.13389121338912133,56,215,19,207,159,188
312429.jpg,0.0,0.07112970711297072,0.0,0.3598326359832636,0,222,0,153,222,153
314267.jpg,0.0041841004184100415,0.11715481171548117,0.24686192468619247,0.2301255230125523,1,211,59,184,210,125
314751.jpg,0.0,0.06276150627615062,0.200836820083682,0.29707112970711297,0,224,48,168,224,120
316307.jpg,0.0,0.07112970711297072,0.16317991631799164,0.26359832635983266,0,222,39,176,222,137
316805.jpg,0.100418410041841,0.06694560669456066,0.06276150627615062,0.26778242677824265,24,223,15,175,199,160
317662.jpg,0.07531380753138076,0.1799163179916318,0.0,0.3682008368200837,18,196,0,151,178,151
318096.jpg,0.20920502092050208,0.19246861924686193,0.25523012552301255,0.12133891213389121,50,193,61,210,143,149
318582.jpg,0.0794979079497908,0.12133891213389121,0.17573221757322174,0.18828451882845187,19,210,42,194,191,152
318953.jpg,0.3179916317991632,0.13807531380753138,0.200836820083682,0.2594142259414226,76,206,48,177,130,129
319156.jpg,0.029288702928870293,0.06694560669456066,0.14225941422594143,0.21338912133891214,7,223,34,188,216,154
319934.jpg,0.11715481171548117,0.08786610878661087,0.19246861924686193,0.06694560669456066,28,218,46,223,190,177
319965.jpg,0.03347280334728033,0.1087866108786611,0.02092050209205021,0.3682008368200837,8,213,5,151,205,146
319999.jpg,0.3472803347280335,0.16317991631799164,0.32217573221757323,0.4476987447698745,83,200,77,132,117,55
320400.jpg,0.02510460251046025,0.06694560669456066,0.06276150627615062,0.06694560669456066,6,223,15,223,217,208
321081.jpg,0.0,0.06276150627615062,0.17573221757322174,0.18828451882845187,0,224,42,194,224,152
321193.jpg,0.12552301255230125,0.1589958158995816,0.24267782426778242,0.06694560669456066,30,201,58,223,171,165
321229.jpg,0.029288702928870293,0.17573221757322174,0.09623430962343096,0.06694560669456066,7,197,23,223,190,200
321324.jpg,0.04602510460251046,0.0794979079497908,0.13807531380753138,0.2384937238493724,11,220,33,182,209,149
321369.jpg,0.03765690376569038,0.08368200836820083,0.11715481171548117,0.19246861924686193,9,219,28,193,210,165
321412.jpg,0.02510460251046025,0.100418410041841,0.20502092050209206,0.2719665271966527,6,215,49,174,209,125
321573.jpg,0.0041841004184100415,0.06694560669456066,0.10460251046025104,0.34309623430962344,1,223,25,157,222,132
321864.jpg,0.22594142259414227,0.100418410041841,0.29707112970711297,0.06694560669456066,54,215,71,223,161,152
321910.jpg,0.15481171548117154,0.1589958158995816,0.08368200836820083,0.34309623430962344,37,201,20,157,164,137
321950.jpg,0.100418410041841,0.06694560669456066,0.3305439330543933,0.06694560669456066,24,223,79,223,199,144
322338.jpg,0.17573221757322174,0.19665271966527198,0.21338912133891214,0.09623430962343096,42,192,51,216,150,165
322890.jpg,0.02092050209205021,0.06694560669456066,0.1087866108786611,0.1799163179916318,5,223,26,196,218,170
32338.jpg,0.13807531380753138,0.1087866108786611,0.2594142259414226,0.26359832635983266,33,213,62,176,180,114
324784.jpg,0.502092050209205,0.12552301255230125,0.18410041841004185,0.47280334728033474,120,209,44,126,89,82
325938.jpg,0.09205020920502092,0.06694560669456066,0.17573221757322174,0.2719665271966527,22,223,42,174,201,132
327072.jpg,0.02510460251046025,0.09623430962343096,0.09623430962343096,0.2217573221757322,6,216,23,186,210,163
327657.jpg,0.012552301255230125,0.07531380753138076,0.0041841004184100415,0.10460251046025104,3,221,1,214,218,213
328373.jpg,0.2928870292887029,0.18410041841004185,0.4560669456066946,0.15481171548117154,70,195,109,202,125,93
328447.jpg,0.13807531380753138,0.200836820083682,0.10460251046025104,0.15481171548117154,33,191,25,202,158,177
328538.jpg,0.016736401673640166,0.06694560669456066,0.19665271966527198,0.23430962343096234,4,223,47,183,219,136
331086.jpg,0.07112970711297072,0.07531380753138076,0.28870292887029286,0.1799163179916318,17,221,69,196,204,127
333107.jpg,0.301255230125523,0.2928870292887029,0.5230125523012552,0.1506276150627615,72,169,125,203,97,78
333361.jpg,0.3598326359832636,0.18410041841004185,0.4393305439330544,0.1297071129707113,86,195,105,208,109,103
333512.jpg,0.20920502092050208,0.29707112970711297,0.029288702928870293,0.06694560669456066,50,168,7,223,118,216
334197.jpg,0.0502092050209205,0.06694560669456066,0.22594142259414227,0.24267782426778242,12,223,54,181,211,127
334523.jpg,0.03765690376569038,0.06694560669456066,0.13389121338912133,0.35564853556485354,9,223,32,154,214,122
334696.jpg,0.0,0.06276150627615062,0.03765690376569038,0.23430962343096234,0,224,9,183,224,174
335400.jpg,0.012552301255230125,0.0794979079497908,0.0,0.06276150627615062,3,220,0,224,217,224
335630.jpg,0.25523012552301255,0.2301255230125523,0.12552301255230125,0.4435146443514644,61,184,30,133,123,103
335876.jpg,0.07112970711297072,0.1087866108786611,0.17573221757322174,0.2510460251046025,17,213,42,179,196,137
335996.jpg,0.1799163179916318,0.2175732217573222,0.012552301255230125,0.6485355648535565,43,187,3,84,144,81
336076.jpg,0.06276150627615062,0.07112970711297072,0.008368200836820083,0.06694560669456066,15,222,2,223,207,221
336156.jpg,0.02510460251046025,0.12552301255230125,0.18410041841004185,0.3138075313807531,6,209,44,164,203,120
336258.jpg,0.2301255230125523,0.100418410041841,0.18828451882845187,0.0794979079497908,55,215,45,220,160,175
336261.jpg,0.24267782426778242,0.3305439330543933,0.08786610878661087,0.48535564853556484,58,160,21,123,102,102
336275.jpg,0.11715481171548117,0.1506276150627615,0.301255230125523,0.06694560669456066,28,203,72,223,175,151
336287.jpg,0.17154811715481172,0.24686192468619247,0.0041841004184100415,0.07531380753138076,41,180,1,221,139,220
336306.jpg,0.0041841004184100415,0.06694560669456066,0.008368200836820083,0.12552301255230125,1,223,2,209,222,207
336333.jpg,0.20920502092050208,0.07531380753138076,0.02510460251046025,0.14225941422594143,50,221,6,205,171,199
336344.jpg,0.14644351464435146,0.19665271966527198,0.14225941422594143,0.07531380753138076,35,192,34,221,157,187
336803.jpg,0.03347280334728033,0.2719665271966527,0.12133891213389121,0.28870292887029286,8,174,29,170,166,141
337833.jpg,0.1589958158995816,0.17573221757322174,0.04184100418410042,0.3263598326359833,38,197,10,161,159,151
338210.jpg,0.2175732217573222,0.19665271966527198,0.40585774058577406,0.16317991631799164,52,192,97,200,140,103
338252.jpg,0.0,0.06276150627615062,0.0041841004184100415,0.17573221757322174,0,224,1,197,224,196
338696.jpg,0.13389121338912133,0.13807531380753138,0.058577405857740586,0.3472803347280335,32,206,14,156,174,142
342935.jpg,0.10460251046025104,0.1506276150627615,0.11297071129707113,0.100418410041841,25,203,27,215,178,188
343673.jpg,0.0,0.06276150627615062,0.0,0.09205020920502092,0,224,0,217,224,217
34484.jpg,0.25523012552301255,0.200836820083682,0.11715481171548117,0.5146443514644351,61,191,28,116,130,88
349279.jpg,0.0,0.08368200836820083,0.16736401673640167,0.19246861924686193,0,219,40,193,219,153
350201.jpg,0.19246861924686193,0.08368200836820083,0.24267782426778242,0.26778242677824265,46,219,58,175,173,117
351942.jpg,0.23430962343096234,0.2301255230125523,0.03765690376569038,0.34309623430962344,56,184,9,157,128,148
353932.jpg,0.41841004184100417,0.16317991631799164,0.14644351464435146,0.5355648535564853,100,200,35,111,100,76
354676.jpg,0.3807531380753138,0.11297071129707113,0.30962343096234307,0.37656903765690375,91,212,74,149,121,75
357066.jpg,0.21338912133891214,0.27615062761506276,0.0,0.4560669456066946,51,173,0,130,122,130
357128.jpg,0.12133891213389121,0.3472803347280335,0.30962343096234307,0.06694560669456066,29,156,74,223,127,149
357244.jpg,0.0,0.07531380753138076,0.12133891213389121,0.1799163179916318,0,221,29,196,221,167
359557.jpg,0.100418410041841,0.1506276150627615,0.17573221757322174,0.200836820083682,24,203,42,191,179,149
362521.jpg,0.02510460251046025,0.08786610878661087,0.04602510460251046,0.20920502092050208,6,218,11,189,212,178
368139.jpg,0.058577405857740586,0.6192468619246861,0.5648535564853556,0.301255230125523,14,91,135,167,77,32
369738.jpg,0.19665271966527198,0.20502092050209206,0.07112970711297072,0.23430962343096234,47,190,17,183,143,166
381838.jpg,0.02092050209205021,0.1087866108786611,0.07531380753138076,0.37656903765690375,5,213,18,149,208,131
382300.jpg,0.0502092050209205,0.09623430962343096,0.16317991631799164,0.1297071129707113,12,216,39,208,204,169
382638.jpg,0.016736401673640166,0.07112970711297072,0.1506276150627615,0.17154811715481172,4,222,36,198,218,162
382974.jpg,0.12133891213389121,0.13389121338912133,0.03347280334728033,0.19246861924686193,29,207,8,193,178,185
385.jpg,0.3598326359832636,0.32217573221757323,0.4560669456066946,0.09623430962343096,86,162,109,216,76,107
385754.jpg,0.14225941422594143,0.08786610878661087,0.27615062761506276,0.23430962343096234,34,218,66,183,184,117
386591.jpg,0.06694560669456066,0.06694560669456066,0.17154811715481172,0.200836820083682,16,223,41,191,207,150
386997(1).jpg,0.3723849372384937,0.24267782426778242,0.3138075313807531,0.38493723849372385,89,181,75,147,92,72
386997.jpg,0.3723849372384937,0.24267782426778242,0.3138075313807531,0.38493723849372385,89,181,75,147,92,72
388320.jpg,0.20920502092050208,0.17573221757322174,0.502092050209205,0.17573221757322174,50,197,120,197,147,77
390138.jpg,0.0,0.06276150627615062,0.012552301255230125,0.1506276150627615,0,224,3,203,224,200
390965.jpg,0.2803347280334728,0.2594142259414226,0.10460251046025104,0.497907949790795,67,177,25,120,110,95
391270.jpg,0.17573221757322174,0.20920502092050208,0.058577405857740586,0.1506276150627615,42,189,14,203,147,189
39198.jpg,0.12552301255230125,0.2217573221757322,0.012552301255230125,0.34309623430962344,30,186,3,157,156,154
395296.jpg,0.03765690376569038,0.06694560669456066,0.2510460251046025,0.1589958158995816,9,223,60,201,214,141
395357.jpg,0.06276150627615062,0.16317991631799164,0.2217573221757322,0.06694560669456066,15,200,53,223,185,170
399103.jpg,0.008368200836820083,0.1087866108786611,0.1589958158995816,0.2301255230125523,2,213,38,184,211,146
404531.jpg,0.0794979079497908,0.2803347280334728,0.301255230125523,0.4476987447698745,19,172,72,132,153,60
404644.jpg,0.28451882845188287,0.3054393305439331,0.24686192468619247,0.08786610878661087,68,166,59,218,98,159
405786.jpg,0.10460251046025104,0.1799163179916318,0.17573221757322174,0.200836820083682,25,196,42,191,171,149
408110.jpg,0.0041841004184100415,0.15481171548117154,0.11715481171548117,0.27615062761506276,1,202,28,173,201,145
408169.jpg,0.15481171548117154,0.1297071129707113,0.1087866108786611,0.2301255230125523,37,208,26,184,171,158
40831.jpg,0.1297071129707113,0.29707112970711297,0.0502092050209205,0.16317991631799164,31,168,12,200,137,188
408713.jpg,0.09205020920502092,0.06694560669456066,0.10460251046025104,0.17573221757322174,22,223,25,197,201,172
412358.jpg,0.0502092050209205,0.16317991631799164,0.21338912133891214,0.06694560669456066,12,200,51,223,188,172
412957.jpg,0.029288702928870293,0.06694560669456066,0.012552301255230125,0.08786610878661087,7,223,3,218,216,215
415095.jpg,0.0,0.07531380753138076,0.24686192468619247,0.1506276150627615,0,221,59,203,221,144
415198.jpg,0.34309623430962344,0.3054393305439331,0.14644351464435146,0.7154811715481172,82,166,35,68,84,33
415270.jpg,0.016736401673640166,0.11297071129707113,0.18828451882845187,0.20502092050209206,4,212,45,190,208,145
418360.jpg,0.08786610878661087,0.06694560669456066,0.12552301255230125,0.2803347280334728,21,223,30,172,202,142
418477.jpg,0.13389121338912133,0.18410041841004185,0.0,0.3514644351464435,32,195,0,155,163,155
418554.jpg,0.03347280334728033,0.12133891213389121,0.17154811715481172,0.2384937238493724,8,210,41,182,202,141
418617.jpg,0.20920502092050208,0.2803347280334728,0.2594142259414226,0.20502092050209206,50,172,62,190,122,128
418688.jpg,0.15481171548117154,0.1589958158995816,0.08368200836820083,0.06694560669456066,37,201,20,223,164,203
418785.jpg,0.1589958158995816,0.20502092050209206,0.02092050209205021,0.36401673640167365,38,190,5,152,152,147
419049.jpg,0.11297071129707113,0.13807531380753138,0.03347280334728033,0.3389121338912134,27,206,8,158,179,150
419972.jpg,0.17154811715481172,0.14644351464435146,0.06694560669456066,0.1297071129707113,41,204,16,208,163,192
420115.jpg,0.19665271966527198,0.2217573221757322,0.3054393305439331,0.4225941422594142,47,186,73,138,139,65
420171.jpg,0.20920502092050208,0.2175732217573222,0.0041841004184100415,0.07112970711297072,50,187,1,222,137,221
420475.jpg,0.008368200836820083,0.06694560669456066,0.14644351464435146,0.17573221757322174,2,223,35,197,221,162
420484.jpg,0.17154811715481172,0.18410041841004185,0.029288702928870293,0.41422594142259417,41,195,7,140,154,133
420520.jpg,0.24267782426778242,0.12552301255230125,0.3723849372384937,0.1589958158995816,58,209,89,201,151,112
420522.jpg,0.1297071129707113,0.1589958158995816,0.2928870292887029,0.15481171548117154,31,201,70,202,170,132
420607.jpg,0.012552301255230125,0.0794979079497908,0.0041841004184100415,0.1589958158995816,3,220,1,201,217,200
420713.jpg,0.17573221757322174,0.18410041841004185,0.0,0.2301255230125523,42,195,0,184,153,184
420743.jpg,0.2175732217573222,0.22594142259414227,0.17573221757322174,0.40585774058577406,52,185,42,142,133,100
420804.jpg,0.08368200836820083,0.18410041841004185,0.1297071129707113,0.06694560669456066,20,195,31,223,175,192
420818.jpg,0.21338912133891214,0.2384937238493724,0.012552301255230125,0.06694560669456066,51,182,3,223,131,220
420857.jpg,0.1799163179916318,0.17573221757322174,0.1506276150627615,0.24267782426778242,43,197,36,181,154,145
421033.jpg,0.27615062761506276,0.30962343096234307,0.2384937238493724,0.3263598326359833,66,165,57,161,99,104
421100.jpg,0.3723849372384937,0.3054393305439331,0.2384937238493724,0.4393305439330544,89,166,57,134,77,77
421109.jpg,0.13807531380753138,0.15481171548117154,0.02510460251046025,0.2175732217573222,33,202,6,187,169,181
421127.jpg,0.20502092050209206,0.2175732217573222,0.2594142259414226,0.24686192468619247,49,187,62,180,138,118
422360.jpg,0.008368200836820083,0.06694560669456066,0.100418410041841,0.200836820083682,2,223,24,191,221,167
422549.jpg,0.19665271966527198,0.08786610878661087,0.04184100418410042,0.38493723849372385,47,218,10,147,171,137
422600.jpg,0.0502092050209205,0.06694560669456066,0.11715481171548117,0.17573221757322174,12,223,28,197,211,169
422676.jpg,0.05439330543933055,0.08368200836820083,0.27615062761506276,0.16736401673640167,13,219,66,199,206,133
423214.jpg,0.2175732217573222,0.06694560669456066,0.200836820083682,0.18410041841004185,52,223,48,195,171,147
424408.jpg,0.012552301255230125,0.6108786610878661,0.1799163179916318,0.497907949790795,3,93,43,120,90,77
425151.jpg,0.06276150627615062,0.2175732217573222,0.02092050209205021,0.09205020920502092,15,187,5,217,172,212
425335.jpg,0.04184100418410042,0.06694560669456066,0.06694560669456066,0.0794979079497908,10,223,16,220,213,204
425533.jpg,0.14644351464435146,0.2217573221757322,0.0502092050209205,0.3179916317991632,35,186,12,163,151,151
425960.jpg,0.12133891213389121,0.1506276150627615,0.0,0.28870292887029286,29,203,0,170,174,170
426217.jpg,0.18828451882845187,0.1087866108786611,0.07531380753138076,0.200836820083682,45,213,18,191,168,173
426295.jpg,0.02510460251046025,0.06694560669456066,0.09623430962343096,0.20920502092050208,6,223,23,189,217,166
426412.jpg,0.26359832635983266,0.1799163179916318,0.2719665271966527,0.06694560669456066,63,196,65,223,133,158
426434.jpg,0.1297071129707113,0.16736401673640167,0.1506276150627615,0.200836820083682,31,199,36,191,168,155
426524.jpg,0.06276150627615062,0.06694560669456066,0.0041841004184100415,0.18828451882845187,15,223,1,194,208,193
426589.jpg,0.3054393305439331,0.12133891213389121,0.14225941422594143,0.16317991631799164,73,210,34,200,137,166
426928.jpg,0.15481171548117154,0.18410041841004185,0.19246861924686193,0.10460251046025104,37,195,46,214,158,168
42719.jpg,0.13807531380753138,0.12133891213389121,0.16317991631799164,0.19665271966527198,33,210,39,192,177,153
427558.jpg,0.0502092050209205,0.06694560669456066,0.008368200836820083,0.06694560669456066,12,223,2,223,211,221
427569.jpg,0.12133891213389121,0.11715481171548117,0.07531380753138076,0.08368200836820083,29,211,18,219,182,201
427596.jpg,0.19665271966527198,0.16317991631799164,0.13807531380753138,0.09623430962343096,47,200,33,216,153,183
428514.jpg,0.10460251046025104,0.10460251046025104,0.016736401673640166,0.14225941422594143,25,214,4,205,189,201
429390.jpg,0.17573221757322174,0.2175732217573222,0.45188284518828453,0.1087866108786611,42,187,108,213,145,105
429806.jpg,0.03765690376569038,0.06694560669456066,0.1799163179916318,0.11715481171548117,9,223,43,211,214,168
429907.jpg,0.2594142259414226,0.26359832635983266,0.401673640167364,0.3263598326359833,62,176,96,161,114,65
431723.jpg,0.0,0.07531380753138076,0.058577405857740586,0.11297071129707113,0,221,14,212,221,198
431751.jpg,0.1087866108786611,0.10460251046025104,0.0502092050209205,0.08368200836820083,26,214,12,219,188,207
431768.jpg,0.07112970711297072,0.08786610878661087,0.0502092050209205,0.18828451882845187,17,218,12,194,201,182
431817.jpg,0.13389121338912133,0.15481171548117154,0.3682008368200837,0.2510460251046025,32,202,88,179,170,91
431925.jpg,0.3682008368200837,0.1589958158995816,0.11715481171548117,0.2301255230125523,88,201,28,184,113,156
432356.jpg,0.07531380753138076,0.22594142259414227,0.17154811715481172,0.2719665271966527,18,185,41,174,167,133
432499.jpg,0.0,0.1087866108786611,0.13807531380753138,0.26359832635983266,0,213,33,176,213,143
432590.jpg,0.02092050209205021,0.09205020920502092,0.13807531380753138,0.200836820083682,5,217,33,191,212,158
432605.jpg,0.0,0.08368200836820083,0.0794979079497908,0.16736401673640167,0,219,19,199,219,180
432739.jpg,0.15481171548117154,0.14644351464435146,0.1297071129707113,0.2301255230125523,37,204,31,184,167,153
433499.jpg,0.016736401673640166,0.2928870292887029,0.17154811715481172,0.22594142259414227,4,169,41,185,165,144
433560.jpg,0.16736401673640167,0.20920502092050208,0.2719665271966527,0.06694560669456066,40,189,65,223,149,158
434119.jpg,0.008368200836820083,0.25523012552301255,0.26778242677824265,0.2510460251046025,2,178,64,179,176,115
434133.jpg,0.016736401673640166,0.06694560669456066,0.22594142259414227,0.21338912133891214,4,223,54,188,219,134
436153.jpg,0.0,0.06276150627615062,0.14644351464435146,0.21338912133891214,0,224,35,188,224,153
436411.jpg,0.10460251046025104,0.6610878661087866,0.6401673640167364,0.12552301255230125,25,81,153,209,56,56
438868.jpg,0.14225941422594143,0.06694560669456066,0.11715481171548117,0.2510460251046025,34,223,28,179,189,151
439320.jpg,0.12133891213389121,0.10460251046025104,0.16317991631799164,0.06694560669456066,29,214,39,223,185,184
439698.jpg,0.0,0.08786610878661087,0.0,0.07112970711297072,0,218,0,222,218,222
440114.jpg,0.0794979079497908,0.16736401673640167,0.0,0.3138075313807531,19,199,0,164,180,164
440326.jpg,0.0041841004184100415,0.16317991631799164,0.10460251046025104,0.1799163179916318,1,200,25,196,199,171
440462.jpg,0.16317991631799164,0.16736401673640167,0.36401673640167365,0.26778242677824265,39,199,87,175,160,88
440527.jpg,0.13807531380753138,0.11297071129707113,0.0,0.20502092050209206,33,212,0,190,179,190
440562.jpg,0.0,0.08786610878661087,0.08368200836820083,0.13807531380753138,0,218,20,206,218,186
442172.jpg,0.19665271966527198,0.14644351464435146,0.100418410041841,0.14644351464435146,47,204,24,204,157,180
443811.jpg,0.016736401673640166,0.06694560669456066,0.30962343096234307,0.26359832635983266,4,223,74,176,219,102
443996.jpg,0.1087866108786611,0.12133891213389121,0.24267782426778242,0.3054393305439331,26,210,58,166,184,108
444272.jpg,0.0,0.06276150627615062,0.008368200836820083,0.14644351464435146,0,224,2,204,224,202
444274.jpg,0.0,0.06694560669456066,0.0,0.06276150627615062,0,223,0,224,223,224
444472.jpg,0.1087866108786611,0.07112970711297072,0.12133891213389121,0.22594142259414227,26,222,29,185,196,156
444495.jpg,0.0041841004184100415,0.07531380753138076,0.058577405857740586,0.12133891213389121,1,221,14,210,220,196
444682.jpg,0.12552301255230125,0.08368200836820083,0.11297071129707113,0.2217573221757322,30,219,27,186,189,159
444775.jpg,0.3598326359832636,0.14225941422594143,0.19246861924686193,0.30962343096234307,86,205,46,165,119,119
445505.jpg,0.03765690376569038,0.11715481171548117,0.21338912133891214,0.27615062761506276,9,211,51,173,202,122
447234.jpg,0.0,0.06276150627615062,0.12133891213389121,0.11297071129707113,0,224,29,212,224,183
447278.jpg,0.1506276150627615,0.18410041841004185,0.0,0.11297071129707113,36,195,0,212,159,212
447677.jpg,0.03347280334728033,0.0794979079497908,0.02092050209205021,0.09623430962343096,8,220,5,216,212,211
447889.jpg,0.23430962343096234,0.17573221757322174,0.06276150627615062,0.18410041841004185,56,197,15,195,141,180
44792.jpg,0.22594142259414227,0.06694560669456066,0.23430962343096234,0.47280334728033474,54,223,56,126,169,70
447996.jpg,0.0041841004184100415,0.08368200836820083,0.1589958158995816,0.20502092050209206,1,219,38,190,218,152
448486.jpg,0.04184100418410042,0.06694560669456066,0.08368200836820083,0.17573221757322174,10,223,20,197,213,177
448535.jpg,0.10460251046025104,0.06694560669456066,0.08786610878661087,0.13389121338912133,25,223,21,207,198,186
448569.jpg,0.0,0.06276150627615062,0.14225941422594143,0.22594142259414227,0,224,34,185,224,151
448572.jpg,0.03347280334728033,0.06694560669456066,0.21338912133891214,0.30962343096234307,8,223,51,165,215,114
448884.jpg,0.12552301255230125,0.1799163179916318,0.04184100418410042,0.07112970711297072,30,196,10,222,166,212
449058.jpg,0.14644351464435146,0.17573221757322174,0.2510460251046025,0.11715481171548117,35,197,60,211,162,151
449082.jpg,0.09623430962343096,0.09623430962343096,0.02510460251046025,0.11715481171548117,23,216,6,211,193,205
449166.jpg,0.0,0.08368200836820083,0.18410041841004185,0.4100418410041841,0,219,44,141,219,97
449373.jpg,0.016736401673640166,0.13389121338912133,0.20920502092050208,0.11297071129707113,4,207,50,212,203,162
449437.jpg,0.03765690376569038,0.08786610878661087,0.10460251046025104,0.15481171548117154,9,218,25,202,209,177
449540.jpg,0.10460251046025104,0.24686192468619247,0.0041841004184100415,0.06694560669456066,25,180,1,223,155,222
449581.jpg,0.16736401673640167,0.22594142259414227,0.09205020920502092,0.18828451882845187,40,185,22,194,145,172
449638.jpg,0.17154811715481172,0.1799163179916318,0.03347280334728033,0.1589958158995816,41,196,8,201,155,193
449831.jpg,0.08786610878661087,0.06694560669456066,0.02510460251046025,0.09623430962343096,21,223,6,216,202,210
449956.jpg,0.0,0.06276150627615062,0.09623430962343096,0.17154811715481172,0,224,23,198,224,175
450043.jpg,0.301255230125523,0.2217573221757322,0.24686192468619247,0.27615062761506276,72,186,59,173,114,114
450054.jpg,0.11297071129707113,0.12552301255230125,0.09205020920502092,0.0794979079497908,27,209,22,220,182,198
450515.jpg,0.02092050209205021,0.06694560669456066,0.029288702928870293,0.19665271966527198,5,223,7,192,218,185
450538.jpg,0.0502092050209205,0.09623430962343096,0.200836820083682,0.41841004184100417,12,216,48,139,204,91
450564.jpg,0.08786610878661087,0.06694560669456066,0.20502092050209206,0.2719665271966527,21,223,49,174,202,125
450602.jpg,0.3305439330543933,0.16317991631799164,0.28451882845188287,0.1799163179916318,79,200,68,196,121,128
450636.jpg,0.02092050209205021,0.13389121338912133,0.1506276150627615,0.14644351464435146,5,207,36,204,202,168
450804.jpg,0.13389121338912133,0.16736401673640167,0.14225941422594143,0.11297071129707113,32,199,34,212,167,178
450835.jpg,0.0,0.11715481171548117,0.03765690376569038,0.08368200836820083,0,211,9,219,211,210
451852.jpg,0.0,0.06694560669456066,0.0041841004184100415,0.09205020920502092,0,223,1,217,223,216
454530.jpg,0.19246861924686193,0.06694560669456066,0.12552301255230125,0.12133891213389121,46,223,30,210,177,180
454893.jpg,0.03765690376569038,0.27615062761506276,0.3305439330543933,0.39330543933054396,9,173,79,145,164,66
458049.jpg,0.03765690376569038,0.12552301255230125,0.0,0.0794979079497908,9,209,0,220,200,220
458472.jpg,0.08368200836820083,0.13389121338912133,0.09623430962343096,0.20502092050209206,20,207,23,190,187,167
458707.jpg,0.02092050209205021,0.06694560669456066,0.07112970711297072,0.18828451882845187,5,223,17,194,218,177
458768.jpg,0.07112970711297072,0.17573221757322174,0.24686192468619247,0.2301255230125523,17,197,59,184,180,125
459504.jpg,0.17573221757322174,0.19246861924686193,0.07531380753138076,0.06694560669456066,42,193,18,223,151,205
460279.jpg,0.08786610878661087,0.1589958158995816,0.16736401673640167,0.24686192468619247,21,201,40,180,180,140
46050.jpg,0.03765690376569038,0.06694560669456066,0.17573221757322174,0.2510460251046025,9,223,42,179,214,137
460881.jpg,0.06694560669456066,0.08368200836820083,0.08786610878661087,0.19665271966527198,16,219,21,192,203,171
461367.jpg,0.2301255230125523,0.18410041841004185,0.2510460251046025,0.25523012552301255,55,195,60,178,140,118
461850.jpg,0.17573221757322174,0.06694560669456066,0.13389121338912133,0.2384937238493724,42,223,32,182,181,150
462009.jpg,0.13807531380753138,0.14225941422594143,0.0041841004184100415,0.2217573221757322,33,205,1,186,172,185
46561.jpg,0.0502092050209205,0.10460251046025104,0.058577405857740586,0.06694560669456066,12,214,14,223,202,209
466690.jpg,0.13389121338912133,0.2928870292887029,0.24267782426778242,0.5146443514644351,32,169,58,116,137,58
466829.jpg,0.012552301255230125,0.12552301255230125,0.12133891213389121,0.18410041841004185,3,209,29,195,206,166
467175.jpg,0.07531380753138076,0.17573221757322174,0.0041841004184100415,0.34309623430962344,18,197,1,157,179,156
467227.jpg,0.1297071129707113,0.1506276150627615,0.05439330543933055,0.5062761506276151,31,203,13,118,172,105
468759.jpg,0.2217573221757322,0.2384937238493724,0.35564853556485354,0.2594142259414226,53,182,85,177,129,92
472430.jpg,0.06694560669456066,0.06694560669456066,0.100418410041841,0.21338912133891214,16,223,24,188,207,164
474275.jpg,0.17154811715481172,0.07112970711297072,0.18410041841004185,0.12133891213389121,41,222,44,210,181,166
476026.jpg,0.1087866108786611,0.20502092050209206,0.02510460251046025,0.33472803347280333,26,190,6,159,164,153
477117.jpg,0.17154811715481172,0.28870292887029286,0.30962343096234307,0.18828451882845187,41,170,74,194,129,120
477130.jpg,0.16736401673640167,0.09623430962343096,0.24267782426778242,0.28451882845188287,40,216,58,171,176,113
477223.jpg,0.15481171548117154,0.20920502092050208,0.07531380753138076,0.06694560669456066,37,189,18,223,152,205
478463.jpg,0.02092050209205021,0.06694560669456066,0.0794979079497908,0.19665271966527198,5,223,19,192,218,173
479104.jpg,0.058577405857740586,0.11715481171548117,0.04184100418410042,0.22594142259414227,14,211,10,185,197,175
481893.jpg,0.016736401673640166,0.19665271966527198,0.029288702928870293,0.11297071129707113,4,192,7,212,188,205
482116.jpg,0.04602510460251046,0.11715481171548117,0.14644351464435146,0.2175732217573222,11,211,35,187,200,152
482880.jpg,0.06694560669456066,0.09205020920502092,0.18828451882845187,0.27615062761506276,16,217,45,173,201,128
483677.jpg,0.0,0.06276150627615062,0.0,0.06276150627615062,0,224,0,224,224,224
483785.jpg,0.13807531380753138,0.12133891213389121,0.18828451882845187,0.2301255230125523,33,210,45,184,177,139
483871.jpg,0.3138075313807531,0.20502092050209206,0.12552301255230125,0.6359832635983264,75,190,30,87,115,57
483909.jpg,0.0041841004184100415,0.13389121338912133,0.19665271966527198,0.30962343096234307,1,207,47,165,206,118
484051.jpg,0.0,0.06276150627615062,0.03347280334728033,0.06694560669456066,0,224,8,223,224,215
484143.jpg,0.02510460251046025,0.06694560669456066,0.11715481171548117,0.3138075313807531,6,223,28,164,217,136
484306.jpg,0.03765690376569038,0.06694560669456066,0.0794979079497908,0.11715481171548117,9,223,19,211,214,192
484610.jpg,0.29707112970711297,0.2928870292887029,0.12552301255230125,0.5062761506276151,71,169,30,118,98,88
484982.jpg,0.02092050209205021,0.20502092050209206,0.008368200836820083,0.3807531380753138,5,190,2,148,185,146
485064.jpg,0.02510460251046025,0.06694560669456066,0.13389121338912133,0.2384937238493724,6,223,32,182,217,150
485091.jpg,0.11297071129707113,0.06694560669456066,0.100418410041841,0.1799163179916318,27,223,24,196,196,172
485131.jpg,0.07531380753138076,0.09623430962343096,0.14225941422594143,0.17154811715481172,18,216,34,198,198,164
485148.jpg,0.21338912133891214,0.23430962343096234,0.02092050209205021,0.12133891213389121,51,183,5,210,132,205
485297.jpg,0.16317991631799164,0.18828451882845187,0.0502092050209205,0.4686192468619247,39,194,12,127,155,115
485351.jpg,0.05439330543933055,0.09205020920502092,0.04602510460251046,0.20920502092050208,13,217,11,189,204,178
485398.jpg,0.0041841004184100415,0.06694560669456066,0.15481171548117154,0.2175732217573222,1,223,37,187,222,150
485695.jpg,0.012552301255230125,0.100418410041841,0.24267782426778242,0.18828451882845187,3,215,58,194,212,136
48584.jpg,0.03765690376569038,0.1297071129707113,0.1087866108786611,0.0794979079497908,9,208,26,220,199,194
486295.jpg,0.11297071129707113,0.16317991631799164,0.26778242677824265,0.08368200836820083,27,200,64,219,173,155
486332.jpg,0.07531380753138076,0.08368200836820083,0.2301255230125523,0.2384937238493724,18,219,55,182,201,127
486658.jpg,0.12552301255230125,0.13807531380753138,0.03765690376569038,0.12552301255230125,30,206,9,209,176,200
48705.jpg,0.12552301255230125,0.18828451882845187,0.09205020920502092,0.06694560669456066,30,194,22,223,164,201
488440.jpg,0.058577405857740586,0.06694560669456066,0.200836820083682,0.24267782426778242,14,223,48,181,209,133
488477.jpg,0.08786610878661087,0.18410041841004185,0.0,0.5397489539748954,21,195,0,110,174,110
488852.jpg,0.20502092050209206,0.200836820083682,0.03765690376569038,0.18828451882845187,49,191,9,194,142,185
488897.jpg,0.19665271966527198,0.301255230125523,0.4811715481171548,0.24267782426778242,47,167,115,181,120,66
48921.jpg,0.03347280334728033,0.06694560669456066,0.1799163179916318,0.33472803347280333,8,223,43,159,215,116
490311.jpg,0.17573221757322174,0.22594142259414227,0.1506276150627615,0.38493723849372385,42,185,36,147,143,111
491727.jpg,0.0041841004184100415,0.06694560669456066,0.26778242677824265,0.401673640167364,1,223,64,143,222,79
492585.jpg,0.200836820083682,0.09205020920502092,0.13807531380753138,0.2301255230125523,48,217,33,184,169,151
498272.jpg,0.3807531380753138,0.14644351464435146,0.3891213389121339,0.18828451882845187,91,204,93,194,113,101
498330.jpg,0.07531380753138076,0.06694560669456066,0.18410041841004185,0.22594142259414227,18,223,44,185,205,141
498993.jpg,0.0502092050209205,0.06694560669456066,0.21338912133891214,0.2301255230125523,12,223,51,184,211,133
499025.jpg,0.0,0.08368200836820083,0.12552301255230125,0.21338912133891214,0,219,30,188,219,158
501113.jpg,0.26359832635983266,0.13389121338912133,0.41841004184100417,0.1297071129707113,63,207,100,208,144,108
501497.jpg,0.0,0.2928870292887029,0.11297071129707113,0.12552301255230125,0,169,27,209,169,182
501714.jpg,0.17154811715481172,0.13389121338912133,0.18828451882845187,0.06694560669456066,41,207,45,223,166,178
502867.jpg,0.2217573221757322,0.25523012552301255,0.04184100418410042,0.09205020920502092,53,178,10,217,125,207
505595.jpg,0.2384937238493724,0.2510460251046025,0.5230125523012552,0.15481171548117154,57,179,125,202,122,77
505963.jpg,0.09205020920502092,0.13389121338912133,0.24267782426778242,0.24267782426778242,22,207,58,181,185,123
509485.jpg,0.12552301255230125,0.10460251046025104,0.22594142259414227,0.3263598326359833,30,214,54,161,184,107
513664.jpg,0.0,0.06694560669456066,0.14644351464435146,0.2301255230125523,0,223,35,184,223,149
513810.jpg,0.34309623430962344,0.18828451882845187,0.33472803347280333,0.19665271966527198,82,194,80,192,112,112
514025.jpg,0.0,0.06694560669456066,0.1799163179916318,0.2594142259414226,0,223,43,177,223,134
514379.jpg,0.0,0.06694560669456066,0.100418410041841,0.17573221757322174,0,223,24,197,223,173
515704.jpg,0.08786610878661087,0.06694560669456066,0.16317991631799164,0.24267782426778242,21,223,39,181,202,142
515757.jpg,0.02510460251046025,0.1589958158995816,0.1506276150627615,0.17154811715481172,6,201,36,198,195,162
516506.jpg,0.15481171548117154,0.18828451882845187,0.06276150627615062,0.10460251046025104,37,194,15,214,157,199
517604.jpg,0.02092050209205021,0.0794979079497908,0.14644351464435146,0.19246861924686193,5,220,35,193,215,158
517758.jpg,0.1506276150627615,0.0794979079497908,0.15481171548117154,0.16736401673640167,36,220,37,199,184,162
520038.jpg,0.02510460251046025,0.06694560669456066,0.2928870292887029,0.2384937238493724,6,223,70,182,217,112
520630.jpg,0.12552301255230125,0.11715481171548117,0.20920502092050208,0.06694560669456066,30,211,50,223,181,173
520878.jpg,0.17573221757322174,0.1297071129707113,0.20920502092050208,0.1589958158995816,42,208,50,201,166,151
522674.jpg,0.0,0.06276150627615062,0.17573221757322174,0.22594142259414227,0,224,42,185,224,143
522972.jpg,0.13807531380753138,0.18828451882845187,0.06694560669456066,0.41841004184100417,33,194,16,139,161,123
524206.jpg,0.11715481171548117,0.16317991631799164,0.12133891213389121,0.07531380753138076,28,200,29,221,172,192
52444.jpg,0.11297071129707113,0.10460251046025104,0.200836820083682,0.17573221757322174,27,214,48,197,187,149
524807.jpg,0.058577405857740586,0.12552301255230125,0.1589958158995816,0.18410041841004185,14,209,38,195,195,157
524844.jpg,0.0,0.100418410041841,0.13807531380753138,0.1799163179916318,0,215,33,196,215,163
52555.jpg,0.05439330543933055,0.0794979079497908,0.18828451882845187,0.27615062761506276,13,220,45,173,207,128
527782.jpg,0.06694560669456066,0.06694560669456066,0.14644351464435146,0.16736401673640167,16,223,35,199,207,164
528219.jpg,0.07531380753138076,0.0794979079497908,0.23430962343096234,0.3263598326359833,18,220,56,161,202,105
528453.jpg,0.20920502092050208,0.2301255230125523,0.14644351464435146,0.6443514644351465,50,184,35,85,134,50
529494.jpg,0.0041841004184100415,0.100418410041841,0.12552301255230125,0.19246861924686193,1,215,30,193,214,163
53066.jpg,0.1297071129707113,0.06694560669456066,0.12552301255230125,0.19246861924686193,31,223,30,193,192,163
530723.jpg,0.05439330543933055,0.1087866108786611,0.18828451882845187,0.3263598326359833,13,213,45,161,200,116
531748.jpg,0.1297071129707113,0.17573221757322174,0.35564853556485354,0.3682008368200837,31,197,85,151,166,66
532245.jpg,0.008368200836820083,0.06694560669456066,0.12133891213389121,0.3054393305439331,2,223,29,166,221,137
533290.jpg,0.016736401673640166,0.602510460251046,0.26778242677824265,0.200836820083682,4,95,64,191,91,127
533780.jpg,0.0,0.07531380753138076,0.0,0.13389121338912133,0,221,0,207,221,207
539422.jpg,0.5899581589958159,0.06694560669456066,0.07112970711297072,0.5815899581589958,141,223,17,100,82,83
541320.jpg,0.12133891213389121,0.09205020920502092,0.03765690376569038,0.06694560669456066,29,217,9,223,188,214
543395.jpg,0.09623430962343096,0.2217573221757322,0.16736401673640167,0.1087866108786611,23,186,40,213,163,173
543747.jpg,0.25523012552301255,0.0794979079497908,0.25523012552301255,0.25523012552301255,61,220,61,178,159,117
543759.jpg,0.20920502092050208,0.27615062761506276,0.1297071129707113,0.41841004184100417,50,173,31,139,123,108
544409.jpg,0.2510460251046025,0.07112970711297072,0.26359832635983266,0.4435146443514644,60,222,63,133,162,70
545017.jpg,0.08786610878661087,0.2719665271966527,0.1799163179916318,0.07112970711297072,21,174,43,222,153,179
546448.jpg,0.18828451882845187,0.11715481171548117,0.34309623430962344,0.06694560669456066,45,211,82,223,166,141
546588.jpg,0.03765690376569038,0.06694560669456066,0.13807531380753138,0.13807531380753138,9,223,33,206,214,173
54766.jpg,0.03765690376569038,0.12133891213389121,0.19665271966527198,0.34309623430962344,9,210,47,157,201,110
550910.jpg,0.0,0.06694560669456066,0.11297071129707113,0.11297071129707113,0,223,27,212,223,185
552681.jpg,0.2510460251046025,0.10460251046025104,0.3054393305439331,0.07531380753138076,60,214,73,221,154,148
552742.jpg,0.05439330543933055,0.13389121338912133,0.3305439330543933,0.35564853556485354,13,207,79,154,194,75
553278.jpg,0.0,0.06276150627615062,0.20920502092050208,0.20502092050209206,0,224,50,190,224,140
553541.jpg,0.17154811715481172,0.16736401673640167,0.2301255230125523,0.15481171548117154,41,199,55,202,158,147
553635.jpg,0.0502092050209205,0.0794979079497908,0.13389121338912133,0.17573221757322174,12,220,32,197,208,165
553891.jpg,0.008368200836820083,0.0794979079497908,0.100418410041841,0.24267782426778242,2,220,24,181,218,157
553962.jpg,0.0794979079497908,0.06694560669456066,0.1297071129707113,0.2301255230125523,19,223,31,184,204,153
554325.jpg,0.07112970711297072,0.0794979079497908,0.03765690376569038,0.1297071129707113,17,220,9,208,203,199
554328.jpg,0.06694560669456066,0.100418410041841,0.1506276150627615,0.200836820083682,16,215,36,191,199,155
554334.jpg,0.10460251046025104,0.2175732217573222,0.11297071129707113,0.11715481171548117,25,187,27,211,162,184
554865.jpg,0.1087866108786611,0.06694560669456066,0.200836820083682,0.23430962343096234,26,223,48,183,197,135
555323.jpg,0.08786610878661087,0.16736401673640167,0.0,0.18410041841004185,21,199,0,195,178,195
555351.jpg,0.18828451882845187,0.13389121338912133,0.20920502092050208,0.1506276150627615,45,207,50,203,162,153
555359.jpg,0.12552301255230125,0.16736401673640167,0.08786610878661087,0.13389121338912133,30,199,21,207,169,186
55536.jpg,0.12133891213389121,0.20502092050209206,0.04184100418410042,0.4811715481171548,29,190,10,124,161,114
555543.jpg,0.0502092050209205,0.06694560669456066,0.12133891213389121,0.19246861924686193,12,223,29,193,211,164
555698.jpg,0.0,0.06276150627615062,0.07531380753138076,0.18828451882845187,0,224,18,194,224,176
555837.jpg,0.0041841004184100415,0.19246861924686193,0.09205020920502092,0.2175732217573222,1,193,22,187,192,165
556166.jpg,0.06694560669456066,0.16736401673640167,0.12552301255230125,0.07531380753138076,16,199,30,221,183,191
556222.jpg,0.06694560669456066,0.06694560669456066,0.22594142259414227,0.1297071129707113,16,223,54,208,207,154
556283.jpg,0.04602510460251046,0.1589958158995816,0.016736401673640166,0.12552301255230125,11,201,4,209,190,205
556339.jpg,0.14644351464435146,0.14225941422594143,0.20920502092050208,0.13807531380753138,35,205,50,206,170,156
556393.jpg,0.0,0.06276150627615062,0.02510460251046025,0.200836820083682,0,224,6,191,224,185
556545.jpg,0.02510460251046025,0.1589958158995816,0.02510460251046025,0.06694560669456066,6,201,6,223,195,217
556617.jpg,0.0,0.06694560669456066,0.058577405857740586,0.13389121338912133,0,223,14,207,223,193
556622.jpg,0.0,0.06694560669456066,0.0,0.19246861924686193,0,223,0,193,223,193
556764.jpg,0.06276150627615062,0.0794979079497908,0.1506276150627615,0.14644351464435146,15,220,36,204,205,168
556840.jpg,0.13389121338912133,0.15481171548117154,0.0041841004184100415,0.2803347280334728,32,202,1,172,170,171
556905.jpg,0.04184100418410042,0.100418410041841,0.02510460251046025,0.06694560669456066,10,215,6,223,205,217
55706.jpg,0.058577405857740586,0.06694560669456066,0.16736401673640167,0.16317991631799164,14,223,40,200,209,160
558027.jpg,0.26359832635983266,0.2510460251046025,0.02510460251046025,0.8493723849372385,63,179,6,36,116,30
563434.jpg,0.20502092050209206,0.09623430962343096,0.3598326359832636,0.13807531380753138,49,216,86,206,167,120
564427.jpg,0.05439330543933055,0.06694560669456066,0.15481171548117154,0.10460251046025104,13,223,37,214,210,177
566763.jpg,0.03347280334728033,0.1087866108786611,0.1087866108786611,0.24267782426778242,8,213,26,181,205,155
567783.jpg,0.04602510460251046,0.13389121338912133,0.13389121338912133,0.23430962343096234,11,207,32,183,196,151
568728.jpg,0.2928870292887029,0.2803347280334728,0.45188284518828453,0.2510460251046025,70,172,108,179,102,71
569334.jpg,0.16317991631799164,0.1799163179916318,0.14644351464435146,0.15481171548117154,39,196,35,202,157,167
569814.jpg,0.0,0.12133891213389121,0.100418410041841,0.09623430962343096,0,210,24,216,210,192
569846.jpg,0.28870292887029286,0.20502092050209206,0.1799163179916318,0.2217573221757322,69,190,43,186,121,143
573512.jpg,0.20502092050209206,0.17154811715481172,0.3723849372384937,0.39330543933054396,49,198,89,145,149,56
574234.jpg,0.2175732217573222,0.21338912133891214,0.4686192468619247,0.1297071129707113,52,188,112,208,136,96
574618.jpg,0.2217573221757322,0.22594142259414227,0.08786610878661087,0.46443514644351463,53,185,21,128,132,107
575187.jpg,0.13389121338912133,0.19246861924686193,0.10460251046025104,0.06694560669456066,32,193,25,223,161,198
576573.jpg,0.09623430962343096,0.2301255230125523,0.016736401673640166,0.06694560669456066,23,184,4,223,161,219
577016.jpg,0.0,0.100418410041841,0.09623430962343096,0.18828451882845187,0,215,23,194,215,171
577075.jpg,0.07531380753138076,0.08786610878661087,0.04602510460251046,0.06694560669456066,18,218,11,223,200,212
577258.jpg,0.02510460251046025,0.09205020920502092,0.05439330543933055,0.18410041841004185,6,217,13,195,211,182
577726.jpg,0.0,0.06276150627615062,0.13807531380753138,0.14225941422594143,0,224,33,205,224,172
577783.jpg,0.029288702928870293,0.07531380753138076,0.13389121338912133,0.2217573221757322,7,221,32,186,214,154
581080.jpg,0.11297071129707113,0.08786610878661087,0.2928870292887029,0.38493723849372385,27,218,70,147,191,77
58650.jpg,0.04184100418410042,0.09205020920502092,0.23430962343096234,0.11297071129707113,10,217,56,212,207,156
59124.jpg,0.0,0.06276150627615062,0.0,0.14225941422594143,0,224,0,205,224,205
591622.jpg,0.06694560669456066,0.15481171548117154,0.24686192468619247,0.23430962343096234,16,202,59,183,186,124
593135.jpg,0.04602510460251046,0.06694560669456066,0.28451882845188287,0.1297071129707113,11,223,68,208,212,140
593657.jpg,0.12133891213389121,0.100418410041841,0.36401673640167365,0.11715481171548117,29,215,87,211,186,124
59534.jpg,0.13389121338912133,0.29707112970711297,0.3138075313807531,0.3179916317991632,32,168,75,163,136,88
596630.jpg,0.07112970711297072,0.07112970711297072,0.11715481171548117,0.10460251046025104,17,222,28,214,205,186
598258.jpg,0.16736401673640167,0.14644351464435146,0.13807531380753138,0.1799163179916318,40,204,33,196,164,163
601122.jpg,0.2510460251046025,0.26778242677824265,0.21338912133891214,0.3054393305439331,60,175,51,166,115,115
604173.jpg,0.13389121338912133,0.26359832635983266,0.0,0.10460251046025104,32,176,0,214,144,214
606254.jpg,0.04602510460251046,0.07112970711297072,0.14225941422594143,0.21338912133891214,11,222,34,188,211,154
606941.jpg,0.02510460251046025,0.11297071129707113,0.07112970711297072,0.22594142259414227,6,212,17,185,206,168
607461.jpg,0.12133891213389121,0.2594142259414226,0.012552301255230125,0.07531380753138076,29,177,3,221,148,218
608121.jpg,0.0,0.09205020920502092,0.09623430962343096,0.2384937238493724,0,217,23,182,217,159
608731.jpg,0.15481171548117154,0.1799163179916318,0.1297071129707113,0.15481171548117154,37,196,31,202,159,171
608868.jpg,0.04184100418410042,0.3054393305439331,0.012552301255230125,0.200836820083682,10,166,3,191,156,188
611600.jpg,0.03765690376569038,0.07112970711297072,0.05439330543933055,0.1589958158995816,9,222,13,201,213,188
611621.jpg,0.0,0.07531380753138076,0.02092050209205021,0.11297071129707113,0,221,5,212,221,207
614966.jpg,0.07531380753138076,0.06694560669456066,0.20502092050209206,0.21338912133891214,18,223,49,188,205,139
615331.jpg,0.016736401673640166,0.200836820083682,0.0,0.06276150627615062,4,191,0,224,187,224
616087.jpg,0.012552301255230125,0.100418410041841,0.016736401673640166,0.17573221757322174,3,215,4,197,212,193
617950.jpg,0.0041841004184100415,0.06694560669456066,0.06276150627615062,0.18828451882845187,1,223,15,194,222,179
618162.jpg,0.05439330543933055,0.11297071129707113,0.0041841004184100415,0.06694560669456066,13,212,1,223,199,222
618238.jpg,0.14225941422594143,0.2175732217573222,0.21338912133891214,0.100418410041841,34,187,51,215,153,164
618456.jpg,0.0,0.06276150627615062,0.22594142259414227,0.2928870292887029,0,224,54,169,224,115
618742.jpg,0.2175732217573222,0.15481171548117154,0.19246861924686193,0.14644351464435146,52,202,46,204,150,158
618921.jpg,0.0502092050209205,0.100418410041841,0.04602510460251046,0.10460251046025104,12,215,11,214,203,203
619055.jpg,0.0,0.06276150627615062,0.0,0.06276150627615062,0,224,0,224,224,224
619309.jpg,0.04602510460251046,0.12133891213389121,0.1506276150627615,0.20502092050209206,11,210,36,190,199,154
619431.jpg,0.4602510460251046,0.22594142259414227,0.3054393305439331,0.3807531380753138,110,185,73,148,75,75
619789.jpg,0.18828451882845187,0.2594142259414226,0.0,0.5941422594142259,45,177,0,97,132,97
619830.jpg,0.0502092050209205,0.100418410041841,0.1297071129707113,0.39748953974895396,12,215,31,144,203,113
619933.jpg,0.18410041841004185,0.2175732217573222,0.24267782426778242,0.15481171548117154,44,187,58,202,143,144
620311.jpg,0.15481171548117154,0.4435146443514644,0.27615062761506276,0.32217573221757323,37,133,66,162,96,96
620682.jpg,0.19665271966527198,0.21338912133891214,0.3598326359832636,0.14644351464435146,47,188,86,204,141,118
624392.jpg,0.22594142259414227,0.20502092050209206,0.2217573221757322,0.15481171548117154,54,190,53,202,136,149
625835.jpg,0.19665271966527198,0.2217573221757322,0.17154811715481172,0.16736401673640167,47,186,41,199,139,158
626101.jpg,0.04184100418410042,0.06694560669456066,0.0794979079497908,0.45188284518828453,10,223,19,131,213,112
627764.jpg,0.03347280334728033,0.11297071129707113,0.08786610878661087,0.1087866108786611,8,212,21,213,204,192
628605.jpg,0.0,0.06276150627615062,0.03765690376569038,0.0794979079497908,0,224,9,220,224,211
629522.jpg,0.07112970711297072,0.07112970711297072,0.200836820083682,0.26359832635983266,17,222,48,176,205,128
629788.jpg,0.09623430962343096,0.12133891213389121,0.09623430962343096,0.39748953974895396,23,210,23,144,187,121
630103.jpg,0.2217573221757322,0.06694560669456066,0.48535564853556484,0.14225941422594143,53,223,116,205,170,89
630125.jpg,0.30962343096234307,0.11715481171548117,0.11297071129707113,0.3138075313807531,74,211,27,164,137,137
63028.jpg,0.5313807531380753,0.06694560669456066,0.5606694560669456,0.18828451882845187,127,223,134,194,96,60
630382.jpg,0.1799163179916318,0.18828451882845187,0.32217573221757323,0.0794979079497908,43,194,77,220,151,143
630420.jpg,0.012552301255230125,0.08786610878661087,0.13807531380753138,0.22594142259414227,3,218,33,185,215,152
630432.jpg,0.03765690376569038,0.100418410041841,0.08368200836820083,0.16736401673640167,9,215,20,199,206,179
630740.jpg,0.08786610878661087,0.07112970711297072,0.08786610878661087,0.14644351464435146,21,222,21,204,201,183
632939.jpg,0.0,0.06276150627615062,0.008368200836820083,0.16736401673640167,0,224,2,199,224,197
634964.jpg,0.16317991631799164,0.1297071129707113,0.02092050209205021,0.14225941422594143,39,208,5,205,169,200
635514.jpg,0.24267782426778242,0.28451882845188287,0.22594142259414227,0.1799163179916318,58,171,54,196,113,142
63643.jpg,0.38493723849372385,0.06694560669456066,0.48535564853556484,0.20920502092050208,92,223,116,189,131,73
636978.jpg,0.22594142259414227,0.2384937238493724,0.4686192468619247,0.19665271966527198,54,182,112,192,128,80
639464.jpg,0.2510460251046025,0.39748953974895396,0.2384937238493724,0.4100418410041841,60,144,57,141,84,84
639603.jpg,0.19246861924686193,0.19665271966527198,0.1087866108786611,0.4811715481171548,46,192,26,124,146,98
640331.jpg,0.11297071129707113,0.16736401673640167,0.12552301255230125,0.20502092050209206,27,199,30,190,172,160
640553.jpg,0.17154811715481172,0.18828451882845187,0.2594142259414226,0.06694560669456066,41,194,62,223,153,161
640965.jpg,0.0,0.07531380753138076,0.0,0.06276150627615062,0,221,0,224,221,224
641981.jpg,0.05439330543933055,0.18828451882845187,0.0041841004184100415,0.07112970711297072,13,194,1,222,181,221
64376.jpg,0.1506276150627615,0.06694560669456066,0.09205020920502092,0.15481171548117154,36,223,22,202,187,180
64443.jpg,0.07531380753138076,0.06694560669456066,0.03347280334728033,0.14644351464435146,18,223,8,204,205,196
64500.jpg,0.1589958158995816,0.2175732217573222,0.02510460251046025,0.12552301255230125,38,187,6,209,149,203
64525.jpg,0.10460251046025104,0.06694560669456066,0.09205020920502092,0.17154811715481172,25,223,22,198,198,176
64527.jpg,0.0,0.06276150627615062,0.02092050209205021,0.06694560669456066,0,224,5,223,224,218
64557.jpg,0.012552301255230125,0.0794979079497908,0.21338912133891214,0.07531380753138076,3,220,51,221,217,170
64573.jpg,0.058577405857740586,0.06694560669456066,0.1506276150627615,0.24686192468619247,14,223,36,180,209,144
64589.jpg,0.11297071129707113,0.06694560669456066,0.2175732217573222,0.14644351464435146,27,223,52,204,196,152
64592.jpg,0.16736401673640167,0.15481171548117154,0.07112970711297072,0.200836820083682,40,202,17,191,162,174
64593.jpg,0.0,0.12133891213389121,0.08368200836820083,0.16736401673640167,0,210,20,199,210,179
648072.jpg,0.25523012552301255,0.1589958158995816,0.04184100418410042,0.301255230125523,61,201,10,167,140,157
648297.jpg,0.12133891213389121,0.1799163179916318,0.2384937238493724,0.06694560669456066,29,196,57,223,167,166
650736.jpg,0.18410041841004185,0.1799163179916318,0.1506276150627615,0.21338912133891214,44,196,36,188,152,152
650777.jpg,0.3598326359832636,0.301255230125523,0.30962343096234307,0.3514644351464435,86,167,74,155,81,81
652390.jpg,0.0,0.06276150627615062,0.18828451882845187,0.26778242677824265,0,224,45,175,224,130
652573.jpg,0.07531380753138076,0.06694560669456066,0.058577405857740586,0.14225941422594143,18,223,14,205,205,191
652610.jpg,0.0,0.06694560669456066,0.07531380753138076,0.1799163179916318,0,223,18,196,223,178
655468.jpg,0.0041841004184100415,0.06694560669456066,0.26778242677824265,0.16317991631799164,1,223,64,200,222,136
658086.jpg,0.0041841004184100415,0.28870292887029286,0.20920502092050208,0.28451882845188287,1,170,50,171,169,121
658239.jpg,0.17154811715481172,0.2594142259414226,0.4686192468619247,0.08368200836820083,41,177,112,219,136,107
658558.jpg,0.18410041841004185,0.20502092050209206,0.016736401673640166,0.08786610878661087,44,190,4,218,146,214
658709.jpg,0.13389121338912133,0.07531380753138076,0.28870292887029286,0.16736401673640167,32,221,69,199,189,130
658907.jpg,0.15481171548117154,0.12133891213389121,0.0794979079497908,0.3389121338912134,37,210,19,158,173,139
65899.jpg,0.02510460251046025,0.1799163179916318,0.04184100418410042,0.06694560669456066,6,196,10,223,190,213
659257.jpg,0.08786610878661087,0.06694560669456066,0.1297071129707113,0.19665271966527198,21,223,31,192,202,161
659394.jpg,0.0,0.08786610878661087,0.2594142259414226,0.2803347280334728,0,218,62,172,218,110
661299.jpg,0.016736401673640166,0.07531380753138076,0.11297071129707113,0.1799163179916318,4,221,27,196,217,169
661360.jpg,0.03765690376569038,0.11297071129707113,0.1297071129707113,0.19246861924686193,9,212,31,193,203,162
66297.jpg,0.09623430962343096,0.200836820083682,0.008368200836820083,0.06694560669456066,23,191,2,223,168,221
663297.jpg,0.0794979079497908,0.100418410041841,0.1589958158995816,0.28451882845188287,19,215,38,171,196,133
663651.jpg,0.07112970711297072,0.09205020920502092,0.012552301255230125,0.11715481171548117,17,217,3,211,200,208
664150.jpg,0.1297071129707113,0.1297071129707113,0.11297071129707113,0.2217573221757322,31,208,27,186,177,159
664371.jpg,0.0,0.09623430962343096,0.1297071129707113,0.17154811715481172,0,216,31,198,216,167
66449.jpg,0.100418410041841,0.35564853556485354,0.3179916317991632,0.24686192468619247,24,154,76,180,130,104
668060.jpg,0.18828451882845187,0.17573221757322174,0.18410041841004185,0.16317991631799164,45,197,44,200,152,156
66996.jpg,0.058577405857740586,0.06694560669456066,0.2175732217573222,0.16736401673640167,14,223,52,199,209,147
670028.jpg,0.04184100418410042,0.1087866108786611,0.09623430962343096,0.21338912133891214,10,213,23,188,203,165
67040.jpg,0.3263598326359833,0.20920502092050208,0.26359832635983266,0.3389121338912134,78,189,63,158,111,95
672655.jpg,0.100418410041841,0.11297071129707113,0.008368200836820083,0.3807531380753138,24,212,2,148,188,146
673687.jpg,0.0,0.1087866108786611,0.1506276150627615,0.18828451882845187,0,213,36,194,213,158
673735.jpg,0.05439330543933055,0.100418410041841,0.20502092050209206,0.30962343096234307,13,215,49,165,202,116
673956.jpg,0.012552301255230125,0.06694560669456066,0.10460251046025104,0.20502092050209206,3,223,25,190,220,165
674059.jpg,0.012552301255230125,0.07112970711297072,0.1506276150627615,0.24267782426778242,3,222,36,181,219,145
674360.jpg,0.0,0.0794979079497908,0.02092050209205021,0.06694560669456066,0,220,5,223,220,218
674385.jpg,0.07531380753138076,0.1087866108786611,0.100418410041841,0.3891213389121339,18,213,24,146,195,122
674625.jpg,0.21338912133891214,0.19665271966527198,0.16736401673640167,0.24686192468619247,51,192,40,180,141,140
675077.jpg,0.21338912133891214,0.22594142259414227,0.4351464435146444,0.20502092050209206,51,185,104,190,134,86
675801.jpg,0.16317991631799164,0.3179916317991632,0.16736401673640167,0.3054393305439331,39,163,40,166,124,126
675848.jpg,0.21338912133891214,0.14225941422594143,0.012552301255230125,0.2175732217573222,51,205,3,187,154,184
677948.jpg,0.03347280334728033,0.08786610878661087,0.20920502092050208,0.2594142259414226,8,218,50,177,210,127
678361.jpg,0.04602510460251046,0.06694560669456066,0.27615062761506276,0.23430962343096234,11,223,66,183,212,117
678378.jpg,0.04184100418410042,0.1087866108786611,0.02092050209205021,0.1297071129707113,10,213,5,208,203,203
678560.jpg,0.1297071129707113,0.16317991631799164,0.05439330543933055,0.2510460251046025,31,200,13,179,169,166
680737.jpg,0.0,0.06276150627615062,0.20502092050209206,0.2719665271966527,0,224,49,174,224,125
681614.jpg,0.15481171548117154,0.17573221757322174,0.04602510460251046,0.29707112970711297,37,197,11,168,160,157
682004.jpg,0.0,0.06276150627615062,0.11715481171548117,0.06694560669456066,0,224,28,223,224,195
682119.jpg,0.17573221757322174,0.11297071129707113,0.3389121338912134,0.13807531380753138,42,212,81,206,170,125
682218.jpg,0.0,0.06694560669456066,0.0,0.11297071129707113,0,223,0,212,223,212
682292.jpg,0.0,0.06276150627615062,0.03765690376569038,0.18828451882845187,0,224,9,194,224,185
682319.jpg,0.058577405857740586,0.06694560669456066,0.13389121338912133,0.19246861924686193,14,223,32,193,209,161
682391.jpg,0.02510460251046025,0.09623430962343096,0.1297071129707113,0.22594142259414227,6,216,31,185,210,154
682471.jpg,0.11715481171548117,0.11715481171548117,0.20502092050209206,0.28451882845188287,28,211,49,171,183,122
682519.jpg,0.0,0.11297071129707113,0.18410041841004185,0.22594142259414227,0,212,44,185,212,141
682586.jpg,0.0,0.08368200836820083,0.10460251046025104,0.2175732217573222,0,219,25,187,219,162
682725.jpg,0.02092050209205021,0.06694560669456066,0.1087866108786611,0.200836820083682,5,223,26,191,218,165
682742.jpg,0.2594142259414226,0.3598326359832636,0.17154811715481172,0.2384937238493724,62,153,41,182,91,141
68396.jpg,0.1799163179916318,0.2217573221757322,0.2384937238493724,0.39330543933054396,43,186,57,145,143,88
684176.jpg,0.0,0.06694560669456066,0.0,0.06276150627615062,0,223,0,224,223,224
685473.jpg,0.13807531380753138,0.17573221757322174,0.20920502092050208,0.08368200836820083,33,197,50,219,164,169
686774.jpg,0.13389121338912133,0.1297071129707113,0.24267782426778242,0.06694560669456066,32,208,58,223,176,165
686791.jpg,0.03765690376569038,0.07112970711297072,0.1506276150627615,0.2217573221757322,9,222,36,186,213,150
687850.jpg,0.0,0.06276150627615062,0.1589958158995816,0.06694560669456066,0,224,38,223,224,185
688061.jpg,0.13389121338912133,0.08786610878661087,0.13807531380753138,0.2803347280334728,32,218,33,172,186,139
689702.jpg,0.058577405857740586,0.3263598326359833,0.18828451882845187,0.28870292887029286,14,161,45,170,147,125
691472.jpg,0.0502092050209205,0.1506276150627615,0.2803347280334728,0.25523012552301255,12,203,67,178,191,111
693745.jpg,0.0,0.06694560669456066,0.13807531380753138,0.2175732217573222,0,223,33,187,223,154
693757.jpg,0.15481171548117154,0.16736401673640167,0.13389121338912133,0.16736401673640167,37,199,32,199,162,167
693816.jpg,0.02510460251046025,0.06694560669456066,0.14644351464435146,0.2301255230125523,6,223,35,184,217,149
695669.jpg,0.19665271966527198,0.17573221757322174,0.4351464435146444,0.10460251046025104,47,197,104,214,150,110
69753.jpg,0.0041841004184100415,0.15481171548117154,0.09205020920502092,0.06694560669456066,1,202,22,223,201,201
69761.jpg,0.06694560669456066,0.08786610878661087,0.09205020920502092,0.0794979079497908,16,218,22,220,202,198
699801.jpg,0.100418410041841,0.09205020920502092,0.0,0.06276150627615062,24,217,0,224,193,224
702346.jpg,0.2510460251046025,0.2510460251046025,0.2301255230125523,0.3305439330543933,60,179,55,160,119,105
703439.jpg,0.6652719665271967,0.07531380753138076,0.6736401673640168,0.10460251046025104,159,221,161,214,62,53
703692.jpg,0.14225941422594143,0.4351464435146444,0.2217573221757322,0.401673640167364,34,135,53,143,101,90
705002.jpg,0.37656903765690375,0.08786610878661087,0.20920502092050208,0.25523012552301255,90,218,50,178,128,128
706325.jpg,0.1506276150627615,0.08368200836820083,0.02510460251046025,0.07112970711297072,36,219,6,222,183,216
707372.jpg,0.0,0.06276150627615062,0.19246861924686193,0.2217573221757322,0,224,46,186,224,140
708769.jpg,0.13389121338912133,0.07531380753138076,0.28870292887029286,0.200836820083682,32,221,69,191,189,122
709101.jpg,0.11715481171548117,0.2217573221757322,0.18410041841004185,0.4895397489539749,28,186,44,122,158,78
714024.jpg,0.0,0.07112970711297072,0.09205020920502092,0.16317991631799164,0,222,22,200,222,178
714219.jpg,0.09205020920502092,0.13389121338912133,0.0,0.06694560669456066,22,207,0,223,185,223
715555.jpg,0.28870292887029286,0.2175732217573222,0.03765690376569038,0.5230125523012552,69,187,9,114,118,105
717711.jpg,0.0794979079497908,0.07531380753138076,0.18828451882845187,0.35564853556485354,19,221,45,154,202,109
718231.jpg,0.04184100418410042,0.13389121338912133,0.1506276150627615,0.06694560669456066,10,207,36,223,197,187
718564.jpg,0.06694560669456066,0.12133891213389121,0.0041841004184100415,0.5355648535564853,16,210,1,111,194,110
719352.jpg,0.08786610878661087,0.18828451882845187,0.0,0.602510460251046,21,194,0,95,173,95
722471.jpg,0.15481171548117154,0.08368200836820083,0.22594142259414227,0.37656903765690375,37,219,54,149,182,95
723208.jpg,0.0041841004184100415,0.10460251046025104,0.13807531380753138,0.13389121338912133,1,214,33,207,213,174
723597.jpg,0.03765690376569038,0.08786610878661087,0.15481171548117154,0.200836820083682,9,218,37,191,209,154
725345.jpg,0.06694560669456066,0.08368200836820083,0.11297071129707113,0.27615062761506276,16,219,27,173,203,146
725585.jpg,0.06276150627615062,0.12133891213389121,0.0041841004184100415,0.06694560669456066,15,210,1,223,195,222
725797.jpg,0.14644351464435146,0.06694560669456066,0.13807531380753138,0.23430962343096234,35,223,33,183,188,150
725900.jpg,0.2175732217573222,0.13389121338912133,0.0,0.32217573221757323,52,207,0,162,155,162
726068.jpg,0.06276150627615062,0.06694560669456066,0.12133891213389121,0.13389121338912133,15,223,29,207,208,178
726385.jpg,0.24267782426778242,0.06694560669456066,0.12552301255230125,0.23430962343096234,58,223,30,183,165,153
726411.jpg,0.0,0.100418410041841,0.0794979079497908,0.11297071129707113,0,215,19,212,215,193
726462.jpg,0.008368200836820083,0.0794979079497908,0.0,0.06276150627615062,2,220,0,224,218,224
726717.jpg,0.02092050209205021,0.10460251046025104,0.1087866108786611,0.1799163179916318,5,214,26,196,209,170
726887.jpg,0.09623430962343096,0.06694560669456066,0.0502092050209205,0.2217573221757322,23,223,12,186,200,174
727023.jpg,0.0,0.06276150627615062,0.1589958158995816,0.28870292887029286,0,224,38,170,224,132
727072.jpg,0.06694560669456066,0.1297071129707113,0.08786610878661087,0.17573221757322174,16,208,21,197,192,176
727164.jpg,0.0,0.06276150627615062,0.14225941422594143,0.18828451882845187,0,224,34,194,224,160
727703.jpg,0.1506276150627615,0.3054393305439331,0.09623430962343096,0.5815899581589958,36,166,23,100,130,77
728025.jpg,0.0502092050209205,0.07112970711297072,0.2175732217573222,0.2384937238493724,12,222,52,182,210,130
728899.jpg,0.02510460251046025,0.26359832635983266,0.18410041841004185,0.26359832635983266,6,176,44,176,170,132
730340.jpg,0.0,0.07112970711297072,0.4100418410041841,0.13389121338912133,0,222,98,207,222,109
730533.jpg,0.2594142259414226,0.27615062761506276,0.3514644351464435,0.4435146443514644,62,173,84,133,111,49
732755.jpg,0.28870292887029286,0.19246861924686193,0.5815899581589958,0.2510460251046025,69,193,139,179,124,40
735130.jpg,0.06694560669456066,0.07531380753138076,0.16736401673640167,0.2510460251046025,16,221,40,179,205,139
736422.jpg,0.02510460251046025,0.1297071129707113,0.07531380753138076,0.3723849372384937,6,208,18,150,202,132
738682.jpg,0.07112970711297072,0.06694560669456066,0.18410041841004185,0.3389121338912134,17,223,44,158,206,114
741053.jpg,0.24267782426778242,0.26359832635983266,0.18828451882845187,0.46443514644351463,58,176,45,128,118,83
742866.jpg,0.09205020920502092,0.10460251046025104,0.12552301255230125,0.23430962343096234,22,214,30,183,192,153
743180.jpg,0.12552301255230125,0.07112970711297072,0.2384937238493724,0.41841004184100417,30,222,57,139,192,82
743396.jpg,0.14225941422594143,0.18828451882845187,0.03347280334728033,0.28870292887029286,34,194,8,170,160,162
748404.jpg,0.016736401673640166,0.16317991631799164,0.06276150627615062,0.12552301255230125,4,200,15,209,196,194
749888.jpg,0.20502092050209206,0.09205020920502092,0.18410041841004185,0.4476987447698745,49,217,44,132,168,88
750097.jpg,0.0,0.13389121338912133,0.0794979079497908,0.20920502092050208,0,207,19,189,207,170
750175.jpg,0.1297071129707113,0.100418410041841,0.2384937238493724,0.2594142259414226,31,215,57,177,184,120
750787.jpg,0.0041841004184100415,0.06694560669456066,0.1297071129707113,0.18410041841004185,1,223,31,195,222,164
750893.jpg,0.16317991631799164,0.07531380753138076,0.029288702928870293,0.2175732217573222,39,221,7,187,182,180
751128.jpg,0.0,0.06276150627615062,0.100418410041841,0.13389121338912133,0,224,24,207,224,183
751334.jpg,0.016736401673640166,0.06694560669456066,0.008368200836820083,0.09623430962343096,4,223,2,216,219,214
751381.jpg,0.0,0.06276150627615062,0.14225941422594143,0.21338912133891214,0,224,34,188,224,154
751415.jpg,0.08368200836820083,0.12133891213389121,0.0794979079497908,0.23430962343096234,20,210,19,183,190,164
751440.jpg,0.0,0.06694560669456066,0.02510460251046025,0.06694560669456066,0,223,6,223,223,217
751559.jpg,0.02510460251046025,0.28870292887029286,0.200836820083682,0.16317991631799164,6,170,48,200,164,152
7527.jpg,0.22594142259414227,0.6485355648535565,0.41841004184100417,0.4560669456066946,54,84,100,130,30,30
755840.jpg,0.20502092050209206,0.1589958158995816,0.37656903765690375,0.18410041841004185,49,201,90,195,152,105
756606.jpg,0.0041841004184100415,0.11297071129707113,0.11297071129707113,0.100418410041841,1,212,27,215,211,188
756705.jpg,0.10460251046025104,0.1799163179916318,0.0502092050209205,0.13807531380753138,25,196,12,206,171,194
756755.jpg,0.4100418410041841,0.20920502092050208,0.33472803347280333,0.33472803347280333,98,189,80,159,91,79
756765.jpg,0.04602510460251046,0.12552301255230125,0.058577405857740586,0.17154811715481172,11,209,14,198,198,184
756913.jpg,0.0041841004184100415,0.06694560669456066,0.19246861924686193,0.2217573221757322,1,223,46,186,222,140
757962.jpg,0.14644351464435146,0.28870292887029286,0.0,0.5355648535564853,35,170,0,111,135,111
759197.jpg,0.20920502092050208,0.3138075313807531,0.02092050209205021,0.4100418410041841,50,164,5,141,114,136
759598.jpg,0.2719665271966527,0.11297071129707113,0.2384937238493724,0.14644351464435146,65,212,57,204,147,147
759611.jpg,0.1589958158995816,0.1087866108786611,0.19665271966527198,0.3054393305439331,38,213,47,166,175,119
760417.jpg,0.15481171548117154,0.18828451882845187,0.14644351464435146,0.07531380753138076,37,194,35,221,157,186
761541.jpg,0.0041841004184100415,0.09623430962343096,0.12552301255230125,0.16736401673640167,1,216,30,199,215,169
763217.jpg,0.0,0.06276150627615062,0.1087866108786611,0.26359832635983266,0,224,26,176,224,150
763310.jpg,0.08786610878661087,0.100418410041841,0.13389121338912133,0.06694560669456066,21,215,32,223,194,191
763981.jpg,0.100418410041841,0.24267782426778242,0.34309623430962344,0.100418410041841,24,181,82,215,157,133
767608.jpg,0.0794979079497908,0.14225941422594143,0.07112970711297072,0.6778242677824268,19,205,17,77,186,60
768751.jpg,0.08786610878661087,0.11297071129707113,0.16736401673640167,0.200836820083682,21,212,40,191,191,151
768849.jpg,0.13807531380753138,0.18410041841004185,0.03347280334728033,0.07531380753138076,33,195,8,221,162,213
769225.jpg,0.100418410041841,0.09205020920502092,0.029288702928870293,0.0794979079497908,24,217,7,220,193,213
769462.jpg,0.08368200836820083,0.07531380753138076,0.1506276150627615,0.18410041841004185,20,221,36,195,201,159
769669.jpg,0.0,0.11715481171548117,0.11297071129707113,0.18410041841004185,0,211,27,195,211,168
771581.jpg,0.03347280334728033,0.1087866108786611,0.12552301255230125,0.19665271966527198,8,213,30,192,205,162
772154.jpg,0.0,0.09205020920502092,0.1506276150627615,0.2719665271966527,0,217,36,174,217,138
772179.jpg,0.0,0.10460251046025104,0.14225941422594143,0.13389121338912133,0,214,34,207,214,173
772495.jpg,0.2510460251046025,0.1799163179916318,0.0,0.11715481171548117,60,196,0,211,136,211
772533.jpg,0.12133891213389121,0.1297071129707113,0.3514644351464435,0.37656903765690375,29,208,84,149,179,65
77268.jpg,0.12552301255230125,0.18410041841004185,0.008368200836820083,0.47280334728033474,30,195,2,126,165,124
776879.jpg,0.0,0.09205020920502092,0.06276150627615062,0.200836820083682,0,217,15,191,217,176
777123.jpg,0.05439330543933055,0.0794979079497908,0.14644351464435146,0.3472803347280335,13,220,35,156,207,121
780788.jpg,0.0,0.200836820083682,0.06276150627615062,0.33472803347280333,0,191,15,159,191,144
782573.jpg,0.09205020920502092,0.11715481171548117,0.2301255230125523,0.2175732217573222,22,211,55,187,189,132
78296.jpg,0.3305439330543933,0.24686192468619247,0.39330543933054396,0.3682008368200837,79,180,94,151,101,57
78362.jpg,0.09205020920502092,0.3179916317991632,0.13807531380753138,0.11297071129707113,22,163,33,212,141,179
783957.jpg,0.18828451882845187,0.18410041841004185,0.100418410041841,0.17154811715481172,45,195,24,198,150,174
784100.jpg,0.08368200836820083,0.2175732217573222,0.100418410041841,0.06694560669456066,20,187,24,223,167,199
786534.jpg,0.13807531380753138,0.21338912133891214,0.3305439330543933,0.06694560669456066,33,188,79,223,155,144
786692.jpg,0.13389121338912133,0.17154811715481172,0.06276150627615062,0.1087866108786611,32,198,15,213,166,198
791326.jpg,0.13807531380753138,0.1087866108786611,0.38493723849372385,0.08786610878661087,33,213,92,218,180,126
791382.jpg,0.10460251046025104,0.07531380753138076,0.18410041841004185,0.34309623430962344,25,221,44,157,196,113
791390.jpg,0.0,0.06276150627615062,0.1589958158995816,0.21338912133891214,0,224,38,188,224,150
791509.jpg,0.05439330543933055,0.11297071129707113,0.2175732217573222,0.5230125523012552,13,212,52,114,199,62
791581.jpg,0.02092050209205021,0.06694560669456066,0.23430962343096234,0.29707112970711297,5,223,56,168,218,112
791690.jpg,0.16736401673640167,0.2217573221757322,0.14225941422594143,0.15481171548117154,40,186,34,202,146,168
791993.jpg,0.18410041841004185,0.18828451882845187,0.06694560669456066,0.16317991631799164,44,194,16,200,150,184
792166.jpg,0.19665271966527198,0.03347280334728033,0.06276150627615062,0.16736401673640167,47,231,15,199,184,184
792239.jpg,0.10460251046025104,0.19246861924686193,0.06694560669456066,0.08368200836820083,25,193,16,219,168,203
794968.jpg,0.34309623430962344,0.200836820083682,0.029288702928870293,0.5732217573221757,82,191,7,102,109,95
802333.jpg,0.26778242677824265,0.23430962343096234,0.3305439330543933,0.35564853556485354,64,183,79,154,119,75
802648.jpg,0.0,0.06276150627615062,0.008368200836820083,0.0794979079497908,0,224,2,220,224,218
803240.jpg,0.11297071129707113,0.11297071129707113,0.012552301255230125,0.2928870292887029,27,212,3,169,185,166
803535.jpg,0.0794979079497908,0.06694560669456066,0.1799163179916318,0.17154811715481172,19,223,43,198,204,155
803867.jpg,0.09205020920502092,0.15481171548117154,0.1799163179916318,0.2803347280334728,22,202,43,172,180,129
804944.jpg,0.012552301255230125,0.100418410041841,0.19246861924686193,0.2928870292887029,3,215,46,169,212,123
807189.jpg,0.09205020920502092,0.08786610878661087,0.14644351464435146,0.20920502092050208,22,218,35,189,196,154
807868.jpg,0.012552301255230125,0.06694560669456066,0.1087866108786611,0.1506276150627615,3,223,26,203,220,177
808048.jpg,0.2301255230125523,0.200836820083682,0.04602510460251046,0.3138075313807531,55,191,11,164,136,153
808182.jpg,0.18410041841004185,0.2217573221757322,0.0041841004184100415,0.5355648535564853,44,186,1,111,142,110
808198.jpg,0.07531380753138076,0.06694560669456066,0.08368200836820083,0.14644351464435146,18,223,20,204,205,184
808253.jpg,0.058577405857740586,0.2301255230125523,0.2301255230125523,0.29707112970711297,14,184,55,168,170,113
808320.jpg,0.21338912133891214,0.15481171548117154,0.06276150627615062,0.15481171548117154,51,202,15,202,151,187
809695.jpg,0.14225941422594143,0.06694560669456066,0.0,0.11715481171548117,34,223,0,211,189,211
809888.jpg,0.41841004184100417,0.19665271966527198,0.37656903765690375,0.2384937238493724,100,192,90,182,92,92
810022.jpg,0.10460251046025104,0.1087866108786611,0.14644351464435146,0.19246861924686193,25,213,35,193,188,158
810355.jpg,0.02510460251046025,0.09205020920502092,0.4560669456066946,0.26359832635983266,6,217,109,176,211,67
810723.jpg,0.09205020920502092,0.06694560669456066,0.12552301255230125,0.28451882845188287,22,223,30,171,201,141
810841.jpg,0.12133891213389121,0.0794979079497908,0.20502092050209206,0.21338912133891214,29,220,49,188,191,139
81265.jpg,0.0041841004184100415,0.06694560669456066,0.21338912133891214,0.41422594142259417,1,223,51,140,222,89
814730.jpg,0.200836820083682,0.20502092050209206,0.3891213389121339,0.20920502092050208,48,190,93,189,142,96
816194.jpg,0.1297071129707113,0.25523012552301255,0.2217573221757322,0.06694560669456066,31,178,53,223,147,170
817318.jpg,0.08368200836820083,0.2510460251046025,0.0,0.20920502092050208,20,179,0,189,159,189
819614.jpg,0.1506276150627615,0.09205020920502092,0.20920502092050208,0.33472803347280333,36,217,50,159,181,109
819661.jpg,0.1589958158995816,0.2301255230125523,0.502092050209205,0.08786610878661087,38,184,120,218,146,98
822953.jpg,0.20502092050209206,0.5271966527196653,0.33472803347280333,0.4476987447698745,49,113,80,132,64,52
824421.jpg,0.0041841004184100415,0.06694560669456066,0.13389121338912133,0.2217573221757322,1,223,32,186,222,154
825875.jpg,0.0,0.07531380753138076,0.0,0.1799163179916318,0,221,0,196,221,196
826207.jpg,0.058577405857740586,0.0794979079497908,0.14644351464435146,0.19246861924686193,14,220,35,193,206,158
827026.jpg,0.5397489539748954,0.11715481171548117,0.1506276150627615,0.5732217573221757,129,211,36,102,82,66
827479.jpg,0.14644351464435146,0.19665271966527198,0.2594142259414226,0.13389121338912133,35,192,62,207,157,145
830166.jpg,0.03765690376569038,0.11715481171548117,0.13389121338912133,0.2384937238493724,9,211,32,182,202,150
830301.jpg,0.18828451882845187,0.19246861924686193,0.05439330543933055,0.14225941422594143,45,193,13,205,148,192
830320.jpg,0.3682008368200837,0.24686192468619247,0.5899581589958159,0.06694560669456066,88,180,141,223,92,82
83339.jpg,0.16736401673640167,0.15481171548117154,0.26778242677824265,0.11715481171548117,40,202,64,211,162,147
834431.jpg,0.029288702928870293,0.06694560669456066,0.14644351464435146,0.24267782426778242,7,223,35,181,216,146
836592.jpg,0.02092050209205021,0.100418410041841,0.14644351464435146,0.301255230125523,5,215,35,167,210,132
836793.jpg,0.06694560669456066,0.07112970711297072,0.17154811715481172,0.19246861924686193,16,222,41,193,206,152
836820.jpg,0.17154811715481172,0.0794979079497908,0.28870292887029286,0.301255230125523,41,220,69,167,179,98
836926.jpg,0.5230125523012552,0.07531380753138076,0.24267782426778242,0.3472803347280335,125,221,58,156,96,98
838577.jpg,0.1506276150627615,0.12552301255230125,0.200836820083682,0.07112970711297072,36,209,48,222,173,174
840007.jpg,0.0,0.09205020920502092,0.09205020920502092,0.07531380753138076,0,217,22,221,217,199
840079.jpg,0.13807531380753138,0.26778242677824265,0.2928870292887029,0.11715481171548117,33,175,70,211,142,141
841040.jpg,0.008368200836820083,0.08368200836820083,0.28451882845188287,0.26359832635983266,2,219,68,176,217,108
841049.jpg,0.0,0.06276150627615062,0.04602510460251046,0.14225941422594143,0,224,11,205,224,194
841258.jpg,0.0,0.11715481171548117,0.0041841004184100415,0.09623430962343096,0,211,1,216,211,215
841642.jpg,0.03765690376569038,0.09205020920502092,0.2803347280334728,0.2719665271966527,9,217,67,174,208,107
843955.jpg,0.20920502092050208,0.09205020920502092,0.20920502092050208,0.25523012552301255,50,217,50,178,167,128
844241.jpg,0.2594142259414226,0.100418410041841,0.301255230125523,0.07112970711297072,62,215,72,222,153,150
844627.jpg,0.3179916317991632,0.36401673640167365,0.2510460251046025,0.4309623430962343,76,152,60,136,76,76
844759.jpg,0.12133891213389121,0.24267782426778242,0.5397489539748954,0.2594142259414226,29,181,129,177,152,48
844911.jpg,0.04602510460251046,0.11715481171548117,0.0041841004184100415,0.06694560669456066,11,211,1,223,200,222
845010.jpg,0.13389121338912133,0.11715481171548117,0.2510460251046025,0.08786610878661087,32,211,60,218,179,158
845035.jpg,0.37656903765690375,0.100418410041841,0.29707112970711297,0.27615062761506276,90,215,71,173,125,102
845057.jpg,0.02092050209205021,0.06694560669456066,0.2217573221757322,0.2175732217573222,5,223,53,187,218,134
845973.jpg,0.1297071129707113,0.23430962343096234,0.016736401673640166,0.09623430962343096,31,183,4,216,152,212
846538.jpg,0.0,0.11297071129707113,0.2175732217573222,0.3138075313807531,0,212,52,164,212,112
847039.jpg,0.4602510460251046,0.1297071129707113,0.15481171548117154,0.3723849372384937,110,208,37,150,98,113
848329.jpg,0.0794979079497908,0.20920502092050208,0.008368200836820083,0.1799163179916318,19,189,2,196,170,194
848709.jpg,0.1087866108786611,0.1087866108786611,0.11715481171548117,0.2719665271966527,26,213,28,174,187,146
849549.jpg,0.1087866108786611,0.12552301255230125,0.16736401673640167,0.25523012552301255,26,209,40,178,183,138
850672.jpg,0.029288702928870293,0.06694560669456066,0.12133891213389121,0.2803347280334728,7,223,29,172,216,143
851100.jpg,0.14644351464435146,0.16736401673640167,0.3263598326359833,0.06694560669456066,35,199,78,223,164,145
851322.jpg,0.2175732217573222,0.20920502092050208,0.06276150627615062,0.11297071129707113,52,189,15,212,137,197
851457.jpg,0.16317991631799164,0.200836820083682,0.2803347280334728,0.3138075313807531,39,191,67,164,152,97
852816.jpg,0.17154811715481172,0.2384937238493724,0.08786610878661087,0.12133891213389121,41,182,21,210,141,189
85284.jpg,0.200836820083682,0.16317991631799164,0.2594142259414226,0.1297071129707113,48,200,62,208,152,146
853476.jpg,0.200836820083682,0.16317991631799164,0.13389121338912133,0.15481171548117154,48,200,32,202,152,170
853595.jpg,0.04602510460251046,0.09205020920502092,0.18828451882845187,0.2217573221757322,11,217,45,186,206,141
853800.jpg,0.03347280334728033,0.07112970711297072,0.09623430962343096,0.1799163179916318,8,222,23,196,214,173
853918.jpg,0.08786610878661087,0.13807531380753138,0.09205020920502092,0.06694560669456066,21,206,22,223,185,201
854018.jpg,0.16317991631799164,0.18410041841004185,0.100418410041841,0.11297071129707113,39,195,24,212,156,188
854136.jpg,0.21338912133891214,0.15481171548117154,0.25523012552301255,0.08368200836820083,51,202,61,219,151,158
854162.jpg,0.2217573221757322,0.06694560669456066,0.0502092050209205,0.06694560669456066,53,223,12,223,170,211
854339.jpg,0.02092050209205021,0.23430962343096234,0.3138075313807531,0.3514644351464435,5,183,75,155,178,80
855838.jpg,0.058577405857740586,0.2384937238493724,0.25523012552301255,0.3723849372384937,14,182,61,150,168,89
855880.jpg,0.0502092050209205,0.07112970711297072,0.15481171548117154,0.2175732217573222,12,222,37,187,210,150
85612.jpg,0.05439330543933055,0.07112970711297072,0.07531380753138076,0.1506276150627615,13,222,18,203,209,185
857447.jpg,0.03347280334728033,0.0794979079497908,0.12552301255230125,0.1506276150627615,8,220,30,203,212,173
858516.jpg,0.18410041841004185,0.06694560669456066,0.03347280334728033,0.2217573221757322,44,223,8,186,179,178
85923.jpg,0.0041841004184100415,0.12133891213389121,0.14225941422594143,0.19665271966527198,1,210,34,192,209,158
859718.jpg,0.0041841004184100415,0.11715481171548117,0.1589958158995816,0.25523012552301255,1,211,38,178,210,140
85972.jpg,0.18410041841004185,0.0794979079497908,0.08786610878661087,0.15481171548117154,44,220,21,202,176,181
86125.jpg,0.008368200836820083,0.100418410041841,0.0794979079497908,0.3682008368200837,2,215,19,151,213,132
86248.jpg,0.016736401673640166,0.06694560669456066,0.09205020920502092,0.4351464435146444,4,223,22,135,219,113
86279.jpg,0.029288702928870293,0.08786610878661087,0.20502092050209206,0.3054393305439331,7,218,49,166,211,117
86280.jpg,0.06276150627615062,0.12552301255230125,0.18410041841004185,0.26359832635983266,15,209,44,176,194,132
863751.jpg,0.06276150627615062,0.10460251046025104,0.13389121338912133,0.16317991631799164,15,214,32,200,199,168
863890.jpg,0.04602510460251046,0.16317991631799164,0.19246861924686193,0.06694560669456066,11,200,46,223,189,177
864645.jpg,0.029288702928870293,0.08368200836820083,0.17154811715481172,0.2803347280334728,7,219,41,172,212,131
864803.jpg,0.1297071129707113,0.1297071129707113,0.21338912133891214,0.28870292887029286,31,208,51,170,177,119
864951.jpg,0.0,0.0794979079497908,0.016736401673640166,0.06694560669456066,0,220,4,223,220,219
8671.jpg,0.02510460251046025,0.09205020920502092,0.1799163179916318,0.4895397489539749,6,217,43,122,211,79
869306.jpg,0.15481171548117154,0.09623430962343096,0.20920502092050208,0.4602510460251046,37,216,50,129,179,79
869949.jpg,0.14644351464435146,0.07531380753138076,0.100418410041841,0.08786610878661087,35,221,24,218,186,194
870748.jpg,0.18410041841004185,0.13807531380753138,0.2175732217573222,0.2803347280334728,44,206,52,172,162,120
870868.jpg,0.16317991631799164,0.3263598326359833,0.058577405857740586,0.11715481171548117,39,161,14,211,122,197
871304.jpg,0.05439330543933055,0.07531380753138076,0.2928870292887029,0.3389121338912134,13,221,70,158,208,88
871369.jpg,0.058577405857740586,0.100418410041841,0.13807531380753138,0.3138075313807531,14,215,33,164,201,131
871430.jpg,0.03347280334728033,0.20502092050209206,0.17573221757322174,0.2803347280334728,8,190,42,172,182,130
871873.jpg,0.0,0.06276150627615062,0.0,0.11297071129707113,0,224,0,212,224,212
871883.jpg,0.2384937238493724,0.3263598326359833,0.12552301255230125,0.301255230125523,57,161,30,167,104,137
874321.jpg,0.3263598326359833,0.19246861924686193,0.23430962343096234,0.4769874476987448,78,193,56,125,115,69
874923.jpg,0.0502092050209205,0.06694560669456066,0.3472803347280335,0.41841004184100417,12,223,83,139,211,56
875870.jpg,0.3807531380753138,0.06694560669456066,0.33472803347280333,0.4435146443514644,91,223,80,133,132,53
875936.jpg,0.04184100418410042,0.07531380753138076,0.2594142259414226,0.28451882845188287,10,221,62,171,211,109
876571.jpg,0.20920502092050208,0.21338912133891214,0.4225941422594142,0.23430962343096234,50,188,101,183,138,82
879197.jpg,0.25523012552301255,0.1087866108786611,0.4435146443514644,0.26778242677824265,61,213,106,175,152,69
879245.jpg,0.32217573221757323,0.4225941422594142,0.11715481171548117,0.3682008368200837,77,138,28,151,61,123
879431.jpg,0.20920502092050208,0.100418410041841,0.2175732217573222,0.29707112970711297,50,215,52,168,165,116
879794.jpg,0.0,0.06276150627615062,0.0,0.1589958158995816,0,224,0,201,224,201
880047.jpg,0.11715481171548117,0.27615062761506276,0.0041841004184100415,0.09205020920502092,28,173,1,217,145,216
880066.jpg,0.08786610878661087,0.06694560669456066,0.100418410041841,0.06694560669456066,21,223,24,223,202,199
880388.jpg,0.15481171548117154,0.17573221757322174,0.03765690376569038,0.21338912133891214,37,197,9,188,160,179
880424.jpg,0.016736401673640166,0.06694560669456066,0.16736401673640167,0.19246861924686193,4,223,40,193,219,153
880492.jpg,0.02092050209205021,0.1087866108786611,0.15481171548117154,0.2301255230125523,5,213,37,184,208,147
881227.jpg,0.3514644351464435,0.2719665271966527,0.6192468619246861,0.1589958158995816,84,174,148,201,90,53
88250.jpg,0.0041841004184100415,0.11297071129707113,0.10460251046025104,0.17154811715481172,1,212,25,198,211,173
885800.jpg,0.40585774058577406,0.2301255230125523,0.06276150627615062,0.5313807531380753,97,184,15,112,87,97
88657.jpg,0.13389121338912133,0.17154811715481172,0.21338912133891214,0.06694560669456066,32,198,51,223,166,172
886632.jpg,0.0,0.08368200836820083,0.16736401673640167,0.17573221757322174,0,219,40,197,219,157
886738.jpg,0.0,0.06276150627615062,0.07531380753138076,0.09205020920502092,0,224,18,217,224,199
890106.jpg,0.058577405857740586,0.06694560669456066,0.08786610878661087,0.12133891213389121,14,223,21,210,209,189
892474.jpg,0.012552301255230125,0.06694560669456066,0.15481171548117154,0.18410041841004185,3,223,37,195,220,158
895152.jpg,0.0,0.09205020920502092,0.08786610878661087,0.20502092050209206,0,217,21,190,217,169
895408.jpg,0.0794979079497908,0.06694560669456066,0.2594142259414226,0.14225941422594143,19,223,62,205,204,143
895668.jpg,0.02092050209205021,0.06694560669456066,0.058577405857740586,0.25523012552301255,5,223,14,178,218,164
897869.jpg,0.16317991631799164,0.17154811715481172,0.200836820083682,0.1087866108786611,39,198,48,213,159,165
897952.jpg,0.16736401673640167,0.06694560669456066,0.21338912133891214,0.26359832635983266,40,223,51,176,183,125
898001.jpg,0.16736401673640167,0.26359832635983266,0.012552301255230125,0.3389121338912134,40,176,3,158,136,155
898151.jpg,0.19246861924686193,0.1799163179916318,0.14644351464435146,0.1087866108786611,46,196,35,213,150,178
898412.jpg,0.28870292887029286,0.22594142259414227,0.20502092050209206,0.3263598326359833,69,185,49,161,116,112
898428.jpg,0.14225941422594143,0.200836820083682,0.3807531380753138,0.07112970711297072,34,191,91,222,157,131
898631.jpg,0.0794979079497908,0.17573221757322174,0.3179916317991632,0.36401673640167365,19,197,76,152,178,76
906413.jpg,0.0,0.06276150627615062,0.13807531380753138,0.18828451882845187,0,224,33,194,224,161
910214.jpg,0.13807531380753138,0.16317991631799164,0.03765690376569038,0.06694560669456066,33,200,9,223,167,214
910354.jpg,0.2594142259414226,0.301255230125523,0.2217573221757322,0.5523012552301255,62,167,53,107,105,54
91045.jpg,0.4602510460251046,0.19246861924686193,0.3472803347280335,0.2384937238493724,110,193,83,182,83,99
910456.jpg,0.0,0.09623430962343096,0.14644351464435146,0.2719665271966527,0,216,35,174,216,139
910618.jpg,0.16736401673640167,0.15481171548117154,0.23430962343096234,0.06694560669456066,40,202,56,223,162,167
910698.jpg,0.19665271966527198,0.3179916317991632,0.19246861924686193,0.5146443514644351,47,163,46,116,116,70
910904.jpg,0.3598326359832636,0.2719665271966527,0.3807531380753138,0.2510460251046025,86,174,91,179,88,88
910905.jpg,0.301255230125523,0.2594142259414226,0.34309623430962344,0.26778242677824265,72,177,82,175,105,93
911352.jpg,0.18828451882845187,0.20920502092050208,0.029288702928870293,0.3598326359832636,45,189,7,153,144,146
913677.jpg,0.24267782426778242,0.2803347280334728,0.2928870292887029,0.5313807531380753,58,172,70,112,114,42
914603.jpg,0.15481171548117154,0.12133891213389121,0.05439330543933055,0.11715481171548117,37,210,13,211,173,198
917120.jpg,0.07112970711297072,0.0794979079497908,0.15481171548117154,0.17573221757322174,17,220,37,197,203,160
917396.jpg,0.0,0.06694560669456066,0.24267782426778242,0.24686192468619247,0,223,58,180,223,122
9191.jpg,0.13389121338912133,0.100418410041841,0.11297071129707113,0.08368200836820083,32,215,27,219,183,192
920866.jpg,0.3389121338912134,0.2301255230125523,0.4811715481171548,0.1087866108786611,81,184,115,213,103,98
920996.jpg,0.18828451882845187,0.14644351464435146,0.07112970711297072,0.28870292887029286,45,204,17,170,159,153
921133.jpg,0.16736401673640167,0.10460251046025104,0.15481171548117154,0.4100418410041841,40,214,37,141,174,104
921176.jpg,0.04184100418410042,0.1506276150627615,0.38493723849372385,0.1297071129707113,10,203,92,208,193,116
921193.jpg,0.24686192468619247,0.4100418410041841,0.39748953974895396,0.2384937238493724,59,141,95,182,82,87
921366.jpg,0.13807531380753138,0.15481171548117154,0.18828451882845187,0.08786610878661087,33,202,45,218,169,173
926254.jpg,0.12133891213389121,0.19246861924686193,0.0,0.24686192468619247,29,193,0,180,164,180
92668.jpg,0.07112970711297072,0.06694560669456066,0.02510460251046025,0.22594142259414227,17,223,6,185,206,179
927062.jpg,0.16736401673640167,0.14225941422594143,0.1506276150627615,0.1506276150627615,40,205,36,203,165,167
929083.jpg,0.0794979079497908,0.06694560669456066,0.19246861924686193,0.10460251046025104,19,223,46,214,204,168
930023.jpg,0.20502092050209206,0.13807531380753138,0.13389121338912133,0.6610878661087866,49,206,32,81,157,49
930413.jpg,0.06694560669456066,0.08368200836820083,0.13389121338912133,0.4560669456066946,16,219,32,130,203,98
930659.jpg,0.16736401673640167,0.09623430962343096,0.1087866108786611,0.32217573221757323,40,216,26,162,176,136
931391.jpg,0.0502092050209205,0.1297071129707113,0.19665271966527198,0.3138075313807531,12,208,47,164,196,117
932065.jpg,0.029288702928870293,0.0794979079497908,0.1589958158995816,0.2928870292887029,7,220,38,169,213,131
932530.jpg,0.3054393305439331,0.1799163179916318,0.2384937238493724,0.4560669456066946,73,196,57,130,123,73
933066.jpg,0.11297071129707113,0.13389121338912133,0.16736401673640167,0.12552301255230125,27,207,40,209,180,169
933111.jpg,0.07112970711297072,0.09623430962343096,0.14225941422594143,0.22594142259414227,17,216,34,185,199,151
934968.jpg,0.008368200836820083,0.1087866108786611,0.11297071129707113,0.200836820083682,2,213,27,191,211,164
93511.jpg,0.008368200836820083,0.07112970711297072,0.19246861924686193,0.26359832635983266,2,222,46,176,220,130
935202.jpg,0.17573221757322174,0.17154811715481172,0.0041841004184100415,0.20920502092050208,42,198,1,189,156,188
935409.jpg,0.016736401673640166,0.11715481171548117,0.1087866108786611,0.18410041841004185,4,211,26,195,207,169
935655.jpg,0.16317991631799164,0.17154811715481172,0.2301255230125523,0.15481171548117154,39,198,55,202,159,147
935900.jpg,0.2594142259414226,0.2217573221757322,0.12133891213389121,0.06694560669456066,62,186,29,223,124,194
937354.jpg,0.18828451882845187,0.19246861924686193,0.14644351464435146,0.2175732217573222,45,193,35,187,148,152
937511.jpg,0.08786610878661087,0.100418410041841,0.17573221757322174,0.200836820083682,21,215,42,191,194,149
938076.jpg,0.0,0.1506276150627615,0.05439330543933055,0.19246861924686193,0,203,13,193,203,180
938290.jpg,0.10460251046025104,0.11715481171548117,0.09623430962343096,0.20502092050209206,25,211,23,190,186,167
939828.jpg,0.04184100418410042,0.12133891213389121,0.1087866108786611,0.24267782426778242,10,210,26,181,200,155
93983.jpg,0.40585774058577406,0.21338912133891214,0.26359832635983266,0.3305439330543933,97,188,63,160,91,97
940378.jpg,0.06694560669456066,0.1087866108786611,0.16317991631799164,0.16317991631799164,16,213,39,200,197,161
940817.jpg,0.029288702928870293,0.13389121338912133,0.0041841004184100415,0.16317991631799164,7,207,1,200,200,199
940859.jpg,0.13389121338912133,0.16736401673640167,0.0502092050209205,0.11297071129707113,32,199,12,212,167,200
940884.jpg,0.1087866108786611,0.07112970711297072,0.0041841004184100415,0.18410041841004185,26,222,1,195,196,194
940895.jpg,0.1506276150627615,0.21338912133891214,0.0,0.23430962343096234,36,188,0,183,152,183
940970.jpg,0.0,0.06694560669456066,0.19246861924686193,0.1799163179916318,0,223,46,196,223,150
943284.jpg,0.02510460251046025,0.06694560669456066,0.21338912133891214,0.2175732217573222,6,223,51,187,217,136
943603.jpg,0.12133891213389121,0.13389121338912133,0.03765690376569038,0.06694560669456066,29,207,9,223,178,214
943892.jpg,0.07531380753138076,0.06694560669456066,0.19246861924686193,0.13807531380753138,18,223,46,206,205,160
943937.jpg,0.08368200836820083,0.1506276150627615,0.03765690376569038,0.08368200836820083,20,203,9,219,183,210
944016.jpg,0.24686192468619247,0.22594142259414227,0.5188284518828452,0.09623430962343096,59,185,124,216,126,92
945181.jpg,0.24686192468619247,0.21338912133891214,0.20920502092050208,0.36401673640167365,59,188,50,152,129,102
948162.jpg,0.12133891213389121,0.06694560669456066,0.13389121338912133,0.19246861924686193,29,223,32,193,194,161
948313.jpg,0.0502092050209205,0.06694560669456066,0.24686192468619247,0.2594142259414226,12,223,59,177,211,118
949223.jpg,0.04184100418410042,0.06694560669456066,0.016736401673640166,0.2175732217573222,10,223,4,187,213,183
949357.jpg,0.016736401673640166,0.07531380753138076,0.09623430962343096,0.10460251046025104,4,221,23,214,217,191
952406.jpg,0.10460251046025104,0.17573221757322174,0.25523012552301255,0.2384937238493724,25,197,61,182,172,121
98576.jpg,0.15481171548117154,0.2384937238493724,0.0,0.5439330543933054,37,182,0,109,145,109
98991.jpg,0.03347280334728033,0.07531380753138076,0.25523012552301255,0.26359832635983266,8,221,61,176,213,115
99226.jpg,0.05439330543933055,0.07531380753138076,0.24267782426778242,0.24267782426778242,13,221,58,181,208,123
99416.jpg,0.016736401673640166,0.06694560669456066,0.22594142259414227,0.19246861924686193,4,223,54,193,219,139
99705.jpg,0.14225941422594143,0.1589958158995816,0.41422594142259417,0.06694560669456066,34,201,99,223,167,124
99830.jpg,0.0502092050209205,0.08368200836820083,0.1589958158995816,0.2217573221757322,12,219,38,186,207,148
